"№ ВД","OBO","Назва регіону України","Місцезнаходження та адреса приміщення для голосування","1) К-сть одержаних бюлетенів","2) К-сть невикористаних бюлетенів","3) К-сть виборців, внесених до списку виборців","4) К-сть виборців, внесених до витягу зі списку виборців","5) К-сть виборців, які отримали бюлетені у приміщенні","6) К-сть виборців, які отримали за місцем перебування","7) Сумарна к-сть виборців, які отримали бюлетені","8) К-сть бюлетенів, що виявилися у кожній скринці","9) К-сть бюлетенів, що не підлягають врахуванню","10) К-сть виборців, які взяли участь у голос. у приміщенні для гол.","11) К-сть виборців, які взяли участь у голос. за місцем перебування","12) К-сть виборців, які взяли участь у голосуванні на виборчій дільниці","13) К-сть бюлетенів, визнаних недійсними","14) Сумарна к-сть голосів виборців ЗА","Виноградник
Тарас
Теофілович","Волощук
Ігор
Іванович","Галига
Петро
Степанович","Гергелюк
Володимир
Іванович","Зелінський
Микола
Романович","Круховська
Галина
Василівна","Круць
Микола
Федорович","Купчак
Володимир
Романович","Людера
Володимир
Ярославович","Мельник
Василь
Іванович","Олексюк
Олег
Миколайович","Пилянська
Марта
Ігорівна","Поліш
Володимир
Віталійович","Симак
Дмитро
Михайлович","Фученко
Василь
Павлович","Шевчук
Євген
Вільямович","Дата підписання протоколу"
"260087","84","Івано-Франківська область","Народний дім, фойє
вул.Я.Осмомисла, 1, м.Галич, Галицький р-н, Івано-Франківська обл., 77100","2052","820","2030","3","1230","2","1232","","0","1230","2","1232","30","1202","18","26","3","111","26","30","206","627","4","4","6","4","48","84","1","4","29.10.12"
"260088","84","Івано-Франківська область","школа №2, спортивний зал
вул.Львівська, 9, м.Галич, Галицький р-н, Івано-Франківська обл., 77100","1252","507","1234","10","737","8","745","","0","737","8","745","11","734","1","12","2","66","10","9","158","373","3","0","6","3","26","59","1","5","29.10.12"
"260089","84","Івано-Франківська область","школа №1, актовий зал
вул.Шевченка, 7, м.Галич, Галицький р-н, Івано-Франківська обл., 77100","1992","868","1980","5","1119","5","1124","","0","1119","5","1124","28","1096","12","28","3","113","25","15","185","583","3","2","9","1","54","60","2","1","29.10.12"
"260090","84","Івано-Франківська область","школа №1, актовий зал
вул.Степана Бандери, 60, м.Бурштин, Галицький р-н, Івано-Франківська обл., 77111","1716","636","1680","20","1060","20","1080","","0","1060","20","1080","23","1057","4","11","8","96","25","10","86","639","2","5","4","2","37","123","0","5","29.10.12"
"260091","84","Івано-Франківська область","Вище професійне училище торгівлі та ресторанного сервісу, актовий зал
вул.Ольги Басараб, 1, м.Бурштин, Галицький р-н, Івано-Франківська обл., 77111","1808","642","1812","7","1159","7","1166","","0","1159","7","1166","19","1147","7","8","4","104","34","4","126","626","6","3","5","7","60","149","1","3","29.10.12"
"260092","84","Івано-Франківська область","школа №3, фойє
вул.Коновальця, 3, м.Бурштин, Галицький р-н, Івано-Франківська обл., 77111","1904","641","1884","6","1257","6","1263","","0","1257","6","1263","36","1227","9","13","13","138","21","11","110","705","2","5","3","7","62","124","2","2","29.10.12"
"260093","84","Івано-Франківська область","Бурштинський енергетичний коледж, читальний зал
вул.Калуська, 4, м.Бурштин, Галицький р-н, Івано-Франківська обл., 77111","1716","624","1700","12","1081","11","1092","","0","1081","11","1092","24","1068","5","17","5","125","16","13","115","573","5","3","4","6","65","113","2","1","29.10.12"
"260094","84","Івано-Франківська область","музична школа, актовий зал
вул.Енергетиків, 15, м.Бурштин, Галицький р-н, Івано-Франківська обл., 77111","1560","545","1554","17","1001","14","1015","","0","1001","14","1015","25","990","5","17","1","69","30","6","93","619","8","1","3","3","50","82","2","1","29.10.12"
"260095","84","Івано-Франківська область","Палац культури ""Прометей"", фойє
вул.Міцкевича, 4, м.Бурштин, Галицький р-н, Івано-Франківська обл., 77111","1484","594","1475","13","879","11","890","","0","879","11","890","25","865","7","17","2","73","17","16","79","512","12","5","4","1","56","62","1","1","29.10.12"
"260096","84","Івано-Франківська область","школа №2, актовий зал
вул.Січових Стрільців, 18, м.Бурштин, Галицький р-н, Івано-Франківська обл., 77111","736","269","724","6","464","3","467","","0","464","3","467","10","457","5","5","1","34","11","7","46","275","2","2","3","1","11","53","0","1","29.10.12"
"260097","84","Івано-Франківська область","міська гімназія, актовий зал
вул.Січових Стрільців, 31, м.Бурштин, Галицький р-н, Івано-Франківська обл., 77111","712","252","701","9","451","9","460","","0","451","9","460","17","443","2","10","3","34","4","8","47","250","6","0","6","0","28","42","0","3","29.10.12"
"260098","84","Івано-Франківська область","народний дім, великий зал
вул.Перемоги, народний дім, с.Вигівка, Галицький р-н, Івано-Франківська обл., 77111","296","74","307","12","210","12","222","","0","210","12","222","0","222","1","0","0","14","5","2","57","126","0","0","4","0","1","12","0","0","28.10.12"
"260099","84","Івано-Франківська область","будинок культури, фойє
вул.Гайова, 5, смт Більшівці, Галицький р-н, Івано-Франківська обл., 77147","2160","768","2150","70","1327","65","1392","","0","1327","65","1392","25","1367","4","17","7","76","35","7","185","702","2","1","19","3","21","285","2","1","29.10.12"
"260100","84","Івано-Франківська область","Народний дім, актовий зал
вул.Галицька, 38, с.Блюдники, Галицький р-н, Івано-Франківська обл., 77161","528","164","526","29","336","28","364","","0","336","28","364","6","358","4","6","1","12","1","3","109","183","0","0","4","1","11","23","0","0","29.10.12"
"260101","84","Івано-Франківська область","бібліотека, читальний зал
вул.С.Бандери, 9, с.Темирівці, Галицький р-н, Івано-Франківська обл., 77161","208","52","208","11","145","11","156","","0","145","11","156","2","154","1","0","1","16","2","0","18","95","0","0","9","0","4","8","0","0","28.10.12"
"260102","84","Івано-Франківська область","школа, кабінет медсестри
вул.Незалежності, 62, с.Пукасівці, Галицький р-н, Івано-Франківська обл., 77161","144","28","141","7","109","7","116","","0","109","7","116","2","114","0","5","2","4","0","0","25","64","0","3","1","0","3","7","0","0","29.10.12"
"260103","84","Івано-Франківська область","сільський клуб, актовий зал
вул.Центральна, 1, с.Ганнівці, Галицький р-н, Івано-Франківська обл., 77161","116","18","117","8","90","8","98","","0","90","8","98","2","96","0","4","0","8","0","0","41","35","0","0","0","0","4","3","0","1","29.10.12"
"260104","84","Івано-Франківська область","школа, актовий зал
вул.Довга, 20, с.Курипів, Галицький р-н, Івано-Франківська обл., 77161","152","42","152","3","107","3","110","","0","107","3","110","3","107","1","5","0","3","4","0","31","53","0","0","0","0","4","6","0","0","29.10.12"
"260105","84","Івано-Франківська область","будинок культури, танцювальний зал
вул.Шевченка, 18, с.Бовшів, Галицький р-н, Івано-Франківська обл., 77132","1100","269","1103","68","771","60","831","","0","771","60","831","14","817","2","3","0","26","31","0","183","379","1","0","9","2","9","169","2","1","29.10.12"
"260110","84","Івано-Франківська область","сільський клуб, зал
вул.Молодіжна, 70, с.Делієве, Галицький р-н, Івано-Франківська обл., 77173","336","116","332","21","199","21","220","","0","199","21","220","6","214","0","2","1","8","1","1","74","102","0","0","2","0","0","22","1","0","29.10.12"
"260111","84","Івано-Франківська область","сільський клуб, зал
вул.Центральна, 69, с.Бишів, Галицький р-н, Івано-Франківська обл., 77173","200","43","199","12","145","12","157","","0","145","12","157","4","153","0","8","0","1","1","0","39","95","0","2","4","0","3","0","0","0","29.10.12"
"260112","84","Івано-Франківська область","школа-сад, актовий зал
вул.Шевченка, школа-сад, с.Демешківці, Галицький р-н, Івано-Франківська обл., 77134","256","84","248","11","163","9","172","","0","163","9","172","2","170","1","4","0","8","2","0","49","72","0","0","6","0","7","20","1","0","28.10.12"
"260113","84","Івано-Франківська область","будинок культури, актовий зал
вул.Миру, 1А, с.Німшин, Галицький р-н, Івано-Франківська обл., 77135","396","108","394","39","254","34","288","","0","254","34","288","12","276","0","4","1","14","0","0","40","154","2","0","5","0","8","48","0","0","29.10.12"
"260114","84","Івано-Франківська область","сільський клуб, актовий зал
вул.Шкільна, 34А, с.Придністров’я, Галицький р-н, Івано-Франківська обл., 77134","260","89","258","19","153","18","171","","0","153","18","171","1","170","1","8","1","6","0","0","19","104","1","1","1","1","3","22","1","1","29.10.12"
"260115","84","Івано-Франківська область","школа, каб.2
вул.Вишнева, 31А, с.Поплавники, Галицький р-н, Івано-Франківська обл., 77134","240","65","241","22","153","22","175","","0","153","22","175","0","175","4","5","1","4","2","2","21","100","0","0","4","0","5","26","1","0","29.10.12"
"260116","84","Івано-Франківська область","будинок культури, актовий зал
вул.Шевченка, 50, с.Дем’янів, Галицький р-н, Івано-Франківська обл., 77131","1400","309","1387","67","1024","67","1091","","0","1024","67","1091","23","1068","6","12","1","89","7","2","157","648","6","1","4","2","25","106","1","1","29.10.12"
"260117","84","Івано-Франківська область","народний дім, фойє
вул.Центральна, народний дім, с.Дитятин, Галицький р-н, Івано-Франківська обл., 77140","336","103","332","14","222","11","233","","0","222","11","233","7","226","1","4","2","8","2","1","35","113","3","2","4","1","14","35","1","0","28.10.12"
"260118","84","Івано-Франківська область","школа, фойє
вул.Шкільна, 35, с.Хохонів, Галицький р-н, Івано-Франківська обл., 77142","312","109","310","25","180","23","203","","0","180","23","203","6","197","1","12","0","14","0","1","78","58","0","2","1","1","4","25","0","0","29.10.12"
"260119","84","Івано-Франківська область","фельдшерсько-акушерський пункт, приймальня
вул.Шевченка, фельдшерсько-акушерський пункт, с.Набережне, Галицький р-н, Івано-Франківська обл., 77141","60","13","58","7","42","5","47","","0","42","5","47","1","46","0","9","0","5","0","0","13","16","0","0","0","0","1","2","0","0","28.10.12"
"260120","84","Івано-Франківська область","школа, фойє
вул.Центральна, 22А, с.Дорогів, Галицький р-н, Івано-Франківська обл., 77152","560","196","551","24","342","22","364","","0","342","22","364","5","359","1","3","0","48","5","2","115","116","0","2","9","3","5","49","1","0","29.10.12"
"260121","84","Івано-Франківська область","школа, приміщення початкових класів
вул.Центральна, 61А, с.Колодіїв, Галицький р-н, Івано-Франківська обл., 77153","488","155","487","24","309","24","333","","0","309","24","333","6","327","7","9","0","48","5","5","81","97","2","2","3","0","10","57","1","0","29.10.12"
"260122","84","Івано-Франківська область","будинок культури, фойє
пл.Незалежності, 3, с.Дубівці, Галицький р-н, Івано-Франківська обл., 77172","1564","371","1580","66","1128","65","1193","","0","1128","65","1193","27","1166","5","11","0","91","62","4","339","565","13","4","7","2","17","42","0","4","29.10.12"
"260123","84","Івано-Франківська область","адмінбудинок сільської ради, зал засідань
вул.І.Франка, 47В, с.Жалибори, Галицький р-н, Івано-Франківська обл., 77126","472","105","470","47","321","46","367","","0","321","46","367","10","357","0","1","2","8","2","0","114","88","1","1","2","0","13","125","0","0","29.10.12"
"260124","84","Івано-Франківська область","Народний дім, танцювальний зал
просп.Шевченка, 1, с.Задністрянське, Галицький р-н, Івано-Франківська обл., 77133","1044","304","1033","28","714","26","740","","0","714","26","740","3","737","5","11","2","39","10","2","159","375","1","2","19","1","21","86","1","3","29.10.12"
"260125","84","Івано-Франківська область","народний дім, фойє
вул.Галицька, народний дім, с.Залуква, Галицький р-н, Івано-Франківська обл., 77160","1864","620","1843","30","1217","27","1244","","0","1217","27","1244","21","1223","8","17","5","69","21","4","198","746","2","5","10","2","35","98","2","1","29.10.12"
"260126","84","Івано-Франківська область","сільський клуб, зал
вул.Шевченка, сільський клуб, с.Шевченкове, Галицький р-н, Івано-Франківська обл., 77160","136","22","134","6","108","6","114","","0","108","6","114","5","109","1","5","0","7","0","1","25","51","0","0","6","0","5","8","0","0","28.10.12"
"260127","84","Івано-Франківська область","будинок культури, зал
вул.Січових Стрільців, 11, с.Кінашів, Галицький р-н, Івано-Франківська обл., 77125","836","199","830","54","584","53","637","","0","584","53","637","12","625","0","2","0","15","8","3","46","162","1","1","3","0","8","375","0","1","29.10.12"
"260128","84","Івано-Франківська область","будинок культури, актовий зал
вул.Шевченка, 10, с.Кінчаки, Галицький р-н, Івано-Франківська обл., 77180","416","163","414","21","234","19","253","","0","234","19","253","7","246","2","8","1","13","5","2","133","53","2","0","2","0","4","19","2","0","29.10.12"
"260129","84","Івано-Франківська область","сільський клуб, актовий зал
вул.Чорновола, 1, с.Кремидів, Галицький р-н, Івано-Франківська обл., 77180","116","50","114","1","65","1","66","","0","65","1","66","4","62","0","7","0","3","0","1","8","19","0","0","0","0","1","23","0","0","29.10.12"
"260131","84","Івано-Франківська область","сільський клуб, зал
вул.Б.Хмельницького, 25, с.Коростовичі, Галицький р-н, Івано-Франківська обл., 77122","368","75","364","25","268","25","293","","0","268","25","293","9","284","2","5","1","23","4","2","54","143","0","1","5","1","7","35","0","1","29.10.12"
"260132","84","Івано-Франківська область","сільський клуб, зал
вул.Б.Хмельницького, 61, с.Куропатники, Галицький р-н, Івано-Франківська обл., 77122","288","81","285","8","199","8","207","","0","199","8","207","16","191","2","5","4","7","0","1","36","73","12","2","3","0","20","24","2","0","29.10.12"
"260134","84","Івано-Франківська область","будинок культури, фойє
вул.Галицька, будинок культури, с.Кукільники, Галицький р-н, Івано-Франківська обл., 77143","376","124","373","33","219","33","252","","0","219","33","252","2","250","2","2","0","7","1","2","56","91","1","0","2","0","2","81","1","2","28.10.12"
"260135","84","Івано-Франківська область","школа, актовий зал
вул.Шевченка, школа, с.Загір’я-Кукільницьке, Галицький р-н, Івано-Франківська обл., 77143","392","124","389","36","233","35","268","","0","233","35","268","6","262","2","11","2","19","1","1","56","72","1","1","3","0","17","72","1","3","28.10.12"
"260136","84","Івано-Франківська область","сільський клуб, актовий зал
вул.Шевченка, 67, с.Курів, Галицький р-н, Івано-Франківська обл., 77125","240","39","236","22","179","22","201","","0","179","22","201","1","200","2","7","0","9","2","0","74","79","0","0","1","0","11","14","1","0","29.10.12"
"260137","84","Івано-Франківська область","сільський клуб, актовий зал
вул.Центральна, 117, с.Лани, Галицький р-н, Івано-Франківська обл., 77174","416","145","408","20","251","20","271","","0","251","20","271","9","262","2","13","3","11","1","1","69","120","1","3","2","1","7","26","0","2","29.10.12"
"260138","84","Івано-Франківська область","будинок культури, актовий зал
вул.Галицька, будинок культури, с.Маріямпіль, Галицький р-н, Івано-Франківська обл., 77181","688","240","686","31","419","29","448","","0","419","29","448","10","438","1","12","1","12","0","1","196","177","2","2","2","0","4","27","0","1","29.10.12"
"260139","84","Івано-Франківська область","сільський клуб, актовий зал
вул.Галицька, сільський клуб, с.Водники, Галицький р-н, Івано-Франківська обл., 77172","392","88","392","17","287","17","304","","0","287","17","304","5","299","0","4","2","34","9","1","102","114","1","1","0","2","4","25","0","0","29.10.12"
"260141","84","Івано-Франківська область","адмінбудинок сільської ради, зал засідань
вул.Тернопільська, 13, с.Медуха, Галицький р-н, Івано-Франківська обл., 77145","340","82","338","27","231","27","258","","0","231","27","258","11","247","0","6","1","17","3","0","68","125","1","0","3","0","2","20","0","1","28.10.12"
"260142","84","Івано-Франківська область","сільський клуб, зал
вул.Дружби, 8, с.Межигірці, Галицький р-н, Івано-Франківська обл., 77171","484","112","482","21","351","21","372","","0","351","21","372","7","365","3","7","2","25","8","3","205","88","0","1","2","0","3","16","1","1","29.10.12"
"260143","84","Івано-Франківська область","будинок культури, фойє
вул.Шкільна, 13, с.Нараївка, Галицький р-н, Івано-Франківська обл., 77191","420","94","416","26","300","26","326","","0","300","26","326","3","323","3","0","0","11","0","1","7","20","1","0","1","0","0","279","0","0","29.10.12"
"260144","84","Івано-Франківська область","школа, спортивний зал
вул.Шкільна, школа, с.Насташине, Галицький р-н, Івано-Франківська обл., 77110","684","113","679","53","518","53","571","","0","518","53","571","13","558","1","11","2","32","6","1","121","284","2","1","4","4","13","74","0","2","29.10.12"
"260145","84","Івано-Франківська область","сільський клуб, зал засідань
вул.Івасюка, 3 с.Куничі, Галицький р-н, Івано-Фраківська обл., 77110","160","12","161","18","130","18","148","","0","130","18","148","1","147","1","3","1","6","0","0","27","81","1","0","3","0","4","20","0","0","29.10.12"
"260146","84","Івано-Франківська область","сільський клуб, актовий зал
вул.Січових Стрільців, 2, с.Нові Скоморохи, Галицький р-н, Івано-Франківська обл., 77123","452","164","443","63","235","53","288","","0","235","53","288","14","274","0","5","3","7","1","1","81","75","2","0","5","1","22","71","0","0","29.10.12"
"260147","84","Івано-Франківська область","школа, актовий зал
вул.Воїнів УПА, 18, с.Старі Скоморохи, Галицький р-н, Івано-Франківська обл., 77124","276","106","277","42","129","41","170","","0","129","41","170","4","166","0","7","0","10","0","0","37","42","0","0","0","0","1","69","0","0","28.10.12"
"260148","84","Івано-Франківська область","сільський клуб, зал
вул.І.Франка, 122А, с.Озеряни, Галицький р-н, Івано-Франківська обл., 77120","352","128","350","8","216","8","224","","0","216","8","224","2","222","1","8","0","23","2","4","55","72","3","1","5","2","16","29","0","1","29.10.12"
"260149","84","Івано-Франківська область","сільський клуб, зал
вул.Т.Шевченка, 106А, с.Слобода, Галицький р-н, Івано-Франківська обл., 77121","332","61","340","16","256","15","271","","0","256","15","271","5","266","2","8","3","15","25","1","40","99","2","0","4","1","11","53","0","2","29.10.12"
"260150","84","Івано-Франківська область","сільський клуб, актовий зал
вул.Зелена, сільський клуб, с.Перлівці, Галицький р-н, Івано-Франківська обл., 77150","84","14","85","8","62","8","70","","0","62","8","70","1","69","0","6","0","0","0","0","6","47","0","0","1","0","4","5","0","0","29.10.12"
"260151","84","Івано-Франківська область","сільський клуб, актовий зал
вул.Центральна, 114, с.Острів, Галицький р-н, Івано-Франківська обл., 77151","120","26","118","11","83","11","94","","0","83","11","94","1","93","3","3","1","4","1","0","21","41","0","2","4","0","4","8","0","1","28.10.12"
"260152","84","Івано-Франківська область","сільський клуб, актовий зал
вул.Шевченка, 17, с.Суботів, Галицький р-н, Івано-Франківська обл., 77151","68","15","67","11","42","11","53","","0","42","11","53","1","52","0","4","0","1","0","0","13","29","0","0","2","0","1","2","0","0","29.10.12"
"260153","84","Івано-Франківська область","сільський клуб, зал
вул.Лесі Українки, 58А, с.Поділля, Галицький р-н, Івано-Франківська обл., 77125","268","95","261","0","173","0","173","","0","173","0","173","8","165","3","8","0","8","1","1","42","78","1","2","0","0","3","18","0","0","29.10.12"
"260155","84","Івано-Франківська область","сільський клуб, зал
вул.Польова, 1, с.Старий Мартинів, Галицький р-н, Івано-Франківська обл., 77130","376","103","373","33","240","33","273","","0","240","33","273","4","269","1","11","1","7","2","1","27","169","1","2","1","0","6","40","0","0","29.10.12"
"260156","84","Івано-Франківська область","сільський клуб, зал
вул.Шевченка, сільський клуб, с.Різдвяни, Галицький р-н, Івано-Франківська обл., 77130","148","29","147","15","104","15","119","","0","104","15","119","7","112","0","7","0","9","0","1","23","61","3","0","1","1","3","3","0","0","29.10.12"
"260157","84","Івано-Франківська область","сільський клуб, зал
вул.Шевченка, 12, с.Новий Мартинів, Галицький р-н, Івано-Франківська обл., 77130","320","79","296","19","224","17","241","","0","224","17","241","12","229","4","6","0","16","1","1","70","80","4","1","2","2","3","39","0","0","29.10.12"
"260158","84","Івано-Франківська область","адмінбудинок сільської ради, зал засідань
вул.Івана Франка, 20, с.Тенетники, Галицький р-н, Івано-Франківська обл., 77116","396","108","395","35","257","31","288","","0","257","31","288","0","288","4","8","1","13","1","0","75","102","1","3","5","2","10","62","1","0","29.10.12"
"260159","84","Івано-Франківська область","сільський клуб, зал
вул.Центральна, 114А, с.Тумир, Галицький р-н, Івано-Франківська обл., 77182","540","232","536","48","260","48","308","","0","260","48","308","10","298","0","3","3","22","7","2","141","81","1","0","8","1","1","28","0","0","29.10.12"
"260160","84","Івано-Франківська область","будинок культури, танцювальний зал
просп.Незалежності, 2, с.Тустань, Галицький р-н, Івано-Франківська обл., 77170","1040","296","1027","39","705","39","744","","0","705","39","744","13","731","4","6","5","42","7","1","206","381","3","0","4","2","12","51","4","3","29.10.12"
"260161","84","Івано-Франківська область","сільський клуб, зал
вул.Шевченка, 1, с.Яблунів, Галицький р-н, Івано-Франківська обл., 77144","388","87","383","44","257","44","301","","0","257","44","301","3","298","2","1","0","14","0","1","53","200","1","0","1","0","11","14","0","0","28.10.12"
"260162","84","Івано-Франківська область","центральна районна лікарня, вестибюль
вул.Я.Осмомисла, 15, м.Галич, Галицький р-н, Івано-Франківська обл., 77100","156","128","33","20","13","15","28","","0","13","15","28","0","28","0","2","0","3","1","0","4","14","0","0","0","0","1","3","0","0","29.10.12"
"260163","84","Івано-Франківська область","Бурштинська міська лікарня, бібліотека
вул.Романа Шухевича, 18, м.Бурштин, Галицький р-н, Івано-Франківська обл., 77111","144","122","24","8","14","8","22","","0","14","8","22","1","21","1","0","0","1","0","0","3","11","0","0","1","0","0","4","0","0","29.10.12"
"260164","84","Івано-Франківська область","Галицька виправна колонія №128, клуб
вул.Шевченка, 3, с.Маріямпіль, Галицький р-н, Івано-Франківська обл., 77181","224","14","220","0","210","0","210","","0","210","0","210","16","194","2","26","0","7","2","2","97","22","0","3","2","0","25","4","0","2","29.10.12"
"260727","84","Івано-Франківська область","центр культури та дозвілля ""Відродження"", зал
вул.Галицька, 32, м.Тисмениця, Тисменицький р-н, Івано-Франківська обл., 77400","1588","612","1573","38","941","35","976","","0","941","35","976","24","952","5","64","68","56","26","4","91","521","3","16","6","1","78","8","4","1","29.10.12"
"260728","84","Івано-Франківська область","народний дім, фойє
вул.Галицька, 15, м.Тисмениця, Тисменицький р-н, Івано-Франківська обл., 77400","1028","363","1034","13","654","11","665","","0","654","11","665","11","654","3","34","54","46","13","4","74","328","0","14","3","0","72","6","3","0","29.10.12"
"260729","84","Івано-Франківська область","хутрофірма ""Тисмениця"", зал
вул.Вербова, 9, м.Тисмениця, Тисменицький р-н, Івано-Франківська обл., 77400","1818","722","1801","14","1084","12","1096","","0","1084","12","1096","15","1081","1","26","111","64","7","0","129","575","0","22","8","1","112","15","7","3","29.10.12"
"260730","84","Івано-Франківська область","школа, фойє
вул.Липова, 14, м.Тисмениця, Тисменицький р-н, Івано-Франківська обл., 77400","1784","780","1767","8","998","6","1004","","0","998","6","1004","18","986","9","46","69","87","28","7","122","469","4","30","8","3","66","12","25","1","29.10.12"
"260731","84","Івано-Франківська область","клуб ""Слобода"", зал
вул.Слобода, 2, м.Тисмениця, Тисменицький р-н, Івано-Франківська обл., 77400","764","272","761","11","481","11","492","","0","481","11","492","6","486","2","19","37","22","10","1","88","250","1","15","1","0","30","5","4","1","29.10.12"
"260732","84","Івано-Франківська область","ТзОВ ""Будгаз"", зал
вул.Шевченка, 51, м.Тисмениця, Тисменицький р-н, Івано-Франківська обл., 77400","996","274","999","13","709","13","722","","0","709","13","722","18","704","0","15","70","23","13","1","42","420","6","13","0","0","79","12","10","0","29.10.12"
"260733","84","Івано-Франківська область","народний дім, зал
вул.С.Бандери, 54, смт Єзупіль, Тисменицький р-н, Івано-Франківська обл., 77411","2248","617","2232","100","1535","96","1631","","0","1535","96","1631","39","1592","20","29","9","149","127","8","265","813","7","10","10","4","69","70","1","1","29.10.12"
"260734","84","Івано-Франківська область","будинок культури, актовий зал
вул.Січових Стрільців, 48, смт Лисець, Тисменицький р-н, Івано-Франківська обл., 77455","2268","780","2243","60","1434","54","1488","","0","1434","54","1488","36","1452","18","56","13","192","74","12","216","693","6","20","23","9","66","33","8","13","29.10.12"
"260735","84","Івано-Франківська область","школа, спортзал
вул.Т.Шевченка, 23, с.Березівка, Тисменицький р-н, Івано-Франківська обл., 77461","1048","289","1054","24","735","24","759","","0","735","24","759","14","745","8","9","6","68","53","4","197","351","1","7","5","4","11","19","0","2","29.10.12"
"260736","84","Івано-Франківська область","школа, спортзал
вул.Т.Шевченка, 89, с.Братківці, Тисменицький р-н, Івано-Франківська обл., 77462","1780","553","1774","63","1167","60","1227","","0","1167","60","1227","30","1197","9","10","5","135","120","1","203","611","2","26","26","2","15","31","0","1","29.10.12"
"260737","84","Івано-Франківська область","будинок культури, зал
вул.Осередок, 95, с.Вільшаниця, Тисменицький р-н, Івано-Франківська обл., 77440","1276","401","1268","83","798","77","875","","0","798","77","875","19","856","7","17","9","58","107","2","199","378","2","13","14","1","30","16","1","2","29.10.12"
"260738","84","Івано-Франківська область","будинок культури, зал
вул.Незалежності, 2А, с.Ганнусівка, Тисменицький р-н, Івано-Франківська обл., 77431","944","298","940","64","584","62","646","","0","584","62","646","14","632","7","8","6","57","57","4","135","323","0","8","5","1","15","6","0","0","29.10.12"
"260739","84","Івано-Франківська область","сільський клуб, зал
вул.Т.Шевченка, 38, с.Добровляни, Тисменицький р-н, Івано-Франківська обл., 77434","144","21","146","10","113","10","123","","0","113","10","123","2","121","3","1","0","7","1","0","30","72","1","0","0","0","0","5","0","1","29.10.12"
"260740","84","Івано-Франківська область","сільський клуб, зал
вул.Лесі Українки, 29, с.Довге, Тисменицький р-н, Івано-Франківська обл., 77433","504","163","505","53","292","49","341","","0","292","49","341","3","338","0","15","2","12","14","1","46","131","1","1","2","1","106","6","0","0","29.10.12"
"260741","84","Івано-Франківська область","будинок культури, зал
вул.Незалежності, 77, с.Драгомирчани, Тисменицький р-н, Івано-Франківська обл., 77454","1400","474","1390","34","900","26","926","","0","900","26","926","22","904","4","13","2","87","16","3","103","567","1","12","16","2","38","33","2","5","29.10.12"
"260742","84","Івано-Франківська область","будинок культури, зал-фойє
вул.Липова-Осада, 22Г, с.Загвіздя, Тисменицький р-н, Івано-Франківська обл., 77450","1528","556","1513","44","929","43","972","","0","929","43","972","26","946","6","14","3","99","40","4","161","527","12","4","36","1","10","22","4","3","29.10.12"
"260743","84","Івано-Франківська область","будинок культури, бібліотека
вул.Липова-Осада, 22Г, с.Загвіздя, Тисменицький р-н, Івано-Франківська обл., 77450","1524","505","1522","26","995","24","1019","","0","995","24","1019","20","999","11","14","8","112","37","4","186","503","16","11","45","0","23","24","1","4","29.10.12"
"260744","84","Івано-Франківська область","сільська рада, депутатська кімната
вул.Миру, 1, с.Клубівці, Тисменицький р-н, Івано-Франківська обл., 77443","1104","400","1095","37","668","36","704","","0","668","36","704","16","688","11","25","17","40","43","0","152","339","3","8","2","3","30","12","3","0","29.10.12"
"260745","84","Івано-Франківська область","сільська рада, зал урочистих подій
вул.Лесі Українки, 26А, с.Клузів, Тисменицький р-н, Івано-Франківська обл., 77423","436","103","432","6","327","6","333","","0","327","6","333","2","331","1","11","0","11","9","2","171","107","0","5","3","0","3","7","0","1","29.10.12"
"260746","84","Івано-Франківська область","сільська рада, зал
вул.Незалежності, 23, с.Козина, Тисменицький р-н, Івано-Франківська обл., 77410","508","120","506","26","363","25","388","","0","363","25","388","12","376","4","27","1","17","33","0","146","121","1","3","4","0","8","11","0","0","29.10.12"
"260747","84","Івано-Франківська область","школа, їдальня
вул.Лесі Українки, 1, с.Колодіївка, Тисменицький р-н, Івано-Франківська обл., 77435","456","137","454","25","298","21","319","","0","298","21","319","6","313","2","8","0","11","16","1","83","182","2","0","3","0","1","3","0","1","29.10.12"
"260748","84","Івано-Франківська область","будинок культури, зал
вул.Незалежності, 4, с.Липівка, Тисменицький р-н, Івано-Франківська обл., 77463","1756","695","1745","59","1003","58","1061","","0","1003","58","1061","28","1033","36","25","7","119","64","5","152","504","4","26","8","6","19","51","3","4","29.10.12"
"260749","84","Івано-Франківська область","школа, хол
вул.Січових Стрільців, 1, с.Майдан, Тисменицький р-н, Івано-Франківська обл., 77420","848","145","835","77","628","75","703","","0","628","75","703","9","694","4","85","2","43","247","5","32","249","0","1","1","2","6","16","0","1","29.10.12"
"260750","84","Івано-Франківська область","сільський клуб, хол
вул.Суха ліщина, 6, с.Нова Гута, Тисменицький р-н, Івано-Франківська обл., 77420","128","37","122","5","86","5","91","","0","86","5","91","2","89","0","12","3","5","6","0","20","35","0","0","2","0","0","4","2","0","29.10.12"
"260751","84","Івано-Франківська область","школа, хол
вул.Шкільна, 1А, с.Марківці, Тисменицький р-н, Івано-Франківська обл., 77470","804","267","794","48","489","48","537","","0","489","48","537","6","531","5","9","7","49","22","6","110","263","0","23","9","1","7","18","0","2","29.10.12"
"260752","84","Івано-Франківська область","сільський клуб, зал
вул.Слобідська, сільський клуб, с.Одаї, Тисменицький р-н, Івано-Франківська обл., 77470","456","169","453","19","269","18","287","","0","269","18","287","9","278","8","23","1","27","4","1","30","142","1","21","2","0","11","4","2","1","29.10.12"
"260753","84","Івано-Франківська область","сільський клуб, зал
вул.Просвіта, сільський клуб, с.Милування, Тисменицький р-н, Івано-Франківська обл., 77437","812","181","810","45","586","45","631","","0","586","45","631","14","617","0","27","14","49","26","4","116","333","0","8","4","0","18","11","4","3","29.10.12"
"260754","84","Івано-Франківська область","будинок культури, малий зал
вул.Грушевського, 6А, с.Нові Кривотули, Тисменицький р-н, Івано-Франківська обл., 77473","796","256","790","29","514","26","540","","0","514","26","540","5","535","8","29","4","15","12","1","97","347","1","5","1","0","9","4","0","2","29.10.12"
"260755","84","Івано-Франківська область","школа, спортзал
вул.Центральна, 16А, с.Терновиця, Тисменицький р-н, Івано-Франківська обл., 77473","252","72","251","14","166","14","180","","0","166","14","180","4","176","3","10","0","6","1","1","40","102","0","5","0","0","7","1","0","0","29.10.12"
"260756","84","Івано-Франківська область","школа, спортзал
вул.Павла Кочуга, 4, с.Павлівка, Тисменицький р-н, Івано-Франківська обл., 77421","1728","465","1723","100","1188","75","1263","","0","1188","75","1263","10","1253","5","18","19","63","365","1","207","475","1","9","5","4","35","38","5","3","29.10.12"
"260757","84","Івано-Франківська область","будинок культури, зал
вул.Т.Шевченка, 94, с.Підлісся, Тисменицький р-н, Івано-Франківська обл., 77451","1888","648","1891","65","1178","62","1240","","0","1178","62","1240","34","1206","17","14","10","115","24","4","360","543","6","5","14","6","42","38","1","7","29.10.12"
"260758","84","Івано-Франківська область","будинок культури, зал
вул.Шевченка, 27, с.Підлужжя, Тисменицький р-н, Івано-Франківська обл., 77442","1432","379","1424","44","1009","44","1053","","0","1009","44","1053","38","1015","14","27","11","87","38","9","187","514","3","7","18","12","35","46","2","5","29.10.12"
"260759","84","Івано-Франківська область","будинок культури, великий зал
вул.Січових Стрільців, 2, с.Підпечери, Тисменицький р-н, Івано-Франківська обл., 77441","2064","552","2057","93","1420","92","1512","","0","1420","92","1512","32","1480","13","20","154","37","9","8","248","796","3","16","14","6","97","47","3","9","29.10.12"
"260760","84","Івано-Франківська область","сільський клуб, актовий зал
вул.Т.Шевченка, 100, с.Побережжя, Тисменицький р-н, Івано-Франківська обл., 77430","1464","435","1458","97","934","95","1029","","0","934","95","1029","21","1008","3","23","23","125","251","4","114","406","2","8","7","0","10","27","0","5","29.10.12"
"260761","84","Івано-Франківська область","сільська рада, кімната
вул.Монастирська, 6, с.Посіч, Тисменицький р-н, Івано-Франківська обл., 77452","84","29","83","0","55","0","55","","0","55","0","55","0","55","0","0","1","8","1","1","28","14","0","0","1","0","1","0","0","0","28.10.12"
"260762","84","Івано-Франківська область","школа, спортзал
вул.Івана Франка, 10, с.Пшеничники, Тисменицький р-н, Івано-Франківська обл., 77407","1072","377","1063","45","650","45","695","","0","650","45","695","15","680","10","15","5","82","12","0","221","267","2","48","0","1","8","5","2","2","29.10.12"
"260763","84","Івано-Франківська область","школа, хол
вул.Т.Шевченка, 40, с.Радча, Тисменицький р-н, Івано-Франківська обл., 77457","2408","692","2392","80","1637","79","1716","","0","1637","79","1716","45","1671","14","39","10","176","18","7","305","949","8","22","23","5","35","52","0","8","29.10.12"
"260764","84","Івано-Франківська область","сільський клуб, зал
вул.І.Франка, 57А, с.Рибне, Тисменицький р-н, Івано-Франківська обл., 77421","248","35","248","15","200","13","213","","0","200","13","213","3","210","0","8","0","8","0","1","99","73","1","2","1","1","5","11","0","0","29.10.12"
"260765","84","Івано-Франківська область","адмінбудинок, актовий зал
вул.Гостинець, 99А, с.Рошнів, Тисменицький р-н, Івано-Франківська обл., 77436","648","191","644","48","409","48","457","","0","409","48","457","11","446","1","29","15","19","31","2","148","166","0","6","2","0","18","8","0","1","29.10.12"
"260766","84","Івано-Франківська область","будинок культури, фойє
вул.Зузука, 7, с.Сілець, Тисменицький р-н, Івано-Франківська обл., 77414","1040","233","1033","22","788","19","807","","0","788","19","807","5","802","3","12","2","52","63","1","209","384","1","3","11","1","16","42","1","1","29.10.12"
"260767","84","Івано-Франківська область","школа, фойє
вул.Незалежності, 50, с.Слобідка, Тисменицький р-н, Івано-Франківська обл., 77472","960","289","952","47","624","47","671","","0","624","47","671","16","655","5","48","4","31","14","2","224","257","0","44","6","0","8","11","0","1","29.10.12"
"260768","84","Івано-Франківська область","школа, актовий зал
вул.Лесі Українки, 9, с.Старі Кривотули, Тисменицький р-н, Івано-Франківська обл., 77474","1544","562","1537","45","939","43","982","","0","939","43","982","13","969","4","35","4","49","16","1","312","462","1","44","5","1","18","12","3","2","29.10.12"
"260769","84","Івано-Франківська область","сільський клуб, актовий зал
вул.І.Франка, 1, с.Красилівка, Тисменицький р-н, Івано-Франківська обл., 77474","884","308","881","34","546","30","576","","0","546","30","576","19","557","5","10","5","49","8","6","195","214","2","9","1","2","37","12","0","2","29.10.12"
"260770","84","Івано-Франківська область","будинок культури, зал 1
вул.Франка, 86А, с.Старий Лисець, Тисменицький р-н, Івано-Франківська обл., 77452","660","244","652","3","413","3","416","","0","413","3","416","13","403","7","9","3","71","15","0","66","180","2","14","9","4","13","4","2","4","29.10.12"
"260771","84","Івано-Франківська область","будинок культури, зал 2
вул.Франка, 86А, с.Старий Лисець, Тисменицький р-н, Івано-Франківська обл., 77452","2384","912","2370","38","1435","37","1472","","0","1435","37","1472","35","1437","6","39","7","164","34","6","252","749","6","72","11","2","49","29","2","9","29.10.12"
"260772","84","Івано-Франківська область","школа, спортзал
вул.Центральна, 51А, с.Стебник, Тисменицький р-н, Івано-Франківська обл., 77453","624","182","627","28","415","27","442","","0","415","27","442","16","426","5","14","5","26","4","2","193","114","4","10","5","0","22","19","2","1","29.10.12"
"260773","84","Івано-Франківська область","школа, спортзал
вул.Шкільна, 28, с.Стриганці, Тисменицький р-н, Івано-Франківська обл., 77432","692","169","685","41","487","36","523","","0","487","36","523","10","513","2","24","1","42","48","1","113","244","0","12","0","1","15","7","1","2","29.10.12"
"260774","84","Івано-Франківська область","будинок культури, зал
вул.Галицька, 5Б, с.Тязів, Тисменицький р-н, Івано-Франківська обл., 77415","944","206","935","47","691","47","738","","0","691","47","738","14","724","2","26","3","54","75","1","178","343","2","5","7","1","4","23","0","0","29.10.12"
"260775","84","Івано-Франківська область","будинок культури, зал
вул.Незалежності, 223А, с.Угринів, Тисменицький р-н, Івано-Франківська обл., 77423","2168","741","2166","30","1399","28","1427","","0","1399","28","1427","31","1396","7","26","7","160","97","11","263","671","2","21","28","11","34","45","4","9","29.10.12"
"260776","84","Івано-Франківська область","школа, спортзал
вул.Незалежності, 188А, с.Угринів, Тисменицький р-н, Івано-Франківська обл., 77423","1044","360","1045","25","662","22","684","","0","662","22","684","13","671","0","29","5","55","98","3","113","268","1","11","8","4","37","32","1","6","29.10.12"
"260777","84","Івано-Франківська область","школа, актовий зал
вул.Молодіжна, 14, с.Узин, Тисменицький р-н, Івано-Франківська обл., 77434","696","243","686","40","414","39","453","","0","414","39","453","25","428","13","39","3","23","32","2","115","171","0","6","3","7","6","2","1","5","29.10.12"
"260778","84","Івано-Франківська область","будинок культури, зал
вул.Шевченка, 26, с.Хом’яківка, Тисменицький р-н, Івано-Франківська обл., 77408","696","228","694","28","441","27","468","","0","441","27","468","10","458","0","17","19","23","4","0","60","179","0","110","1","2","23","16","1","3","29.10.12"
"260779","84","Івано-Франківська область","будинок культури, зал
вул.Січових Стрільців, 9, с.Черніїв, Тисменицький р-н, Івано-Франківська обл., 77460","1372","490","1359","28","856","26","882","","0","856","26","882","29","853","13","13","4","92","38","7","129","495","1","14","5","6","7","24","3","2","29.10.12"
"260780","84","Івано-Франківська область","школа, спортзал
вул.Грушевського, 7, с.Черніїв, Тисменицький р-н, Івано-Франківська обл., 77460","1792","676","1777","40","1079","37","1116","","0","1079","37","1116","30","1086","29","20","9","137","46","5","139","591","5","3","12","5","18","50","5","12","29.10.12"
"260781","84","Івано-Франківська область","школа, фойє
вул.Незалежності, 1А, с.Чорнолізці, Тисменицький р-н, Івано-Франківська обл., 77471","2356","848","2347","119","1391","117","1508","","0","1391","117","1508","9","1499","6","32","10","81","31","8","677","404","0","119","7","0","70","54","0","0","29.10.12"
"260782","84","Івано-Франківська область","будинок культури, зал
вул.Клубна, 1А, с.Чукалівка, Тисменицький р-н, Івано-Франківська обл., 77458","1336","439","1336","23","875","22","897","","0","875","22","897","19","878","6","10","13","113","12","5","186","451","3","10","17","4","16","23","4","5","29.10.12"
"260783","84","Івано-Франківська область","школа, фойє
вул.Галицька, 55, с.Ямниця, Тисменицький р-н, Івано-Франківська обл., 77422","1184","238","1173","51","895","51","946","","0","895","51","946","12","934","3","13","2","22","427","2","217","189","2","1","4","1","14","35","0","2","29.10.12"
"260784","84","Івано-Франківська область","школа, спортзал
вул.Галицька, 55, с.Ямниця, Тисменицький р-н, Івано-Франківська обл., 77422","1492","349","1478","50","1094","49","1143","","0","1094","49","1143","17","1126","2","5","3","30","584","3","207","239","3","2","7","0","13","28","0","0","29.10.12"
"260785","84","Івано-Франківська область","протитуберкульозний диспансер, актовий зал
вул.К.Левицького, 81А, м.Тисмениця, Тисменицький р-н, Івано-Франківська обл., 77400","80","22","75","13","51","7","58","","0","51","7","58","1","57","0","9","1","2","0","0","17","20","0","1","1","2","2","0","2","0","29.10.12"
"260786","84","Івано-Франківська область","центральна районна лікарня, конферензал
вул.Радчанська, 10, смт Лисець, Тисменицький р-н, Івано-Франківська обл., 77455","152","114","50","4","36","2","38","","0","36","2","38","5","33","0","4","1","1","3","1","5","14","0","0","0","0","1","2","0","1","29.10.12"
"260787","84","Івано-Франківська область","народний дім, фойє
вул.Грушевського, 2, м.Тлумач, Тлумацький р-н, Івано-Франківська обл., 78000","1580","679","1558","16","885","16","901","","0","885","16","901","26","875","13","13","6","131","24","25","94","396","1","19","8","0","110","16","5","14","29.10.12"
"260788","84","Івано-Франківська область","школа, актовий зал
вул.Макуха, 11, м.Тлумач, Тлумацький р-н, Івано-Франківська обл., 78000","1664","746","1610","13","905","13","918","","0","905","13","918","27","891","15","13","12","190","30","12","82","381","2","10","6","2","114","6","2","14","29.10.12"
"260789","84","Івано-Франківська область","дитячий садок ""Дюймовочка"", актовий зал
вул.Берегового, 2, м.Тлумач, Тлумацький р-н, Івано-Франківська обл., 78000","1540","594","1520","11","936","10","946","","0","936","10","946","22","924","10","6","5","135","26","8","66","488","11","13","7","1","128","11","1","8","29.10.12"
"260790","84","Івано-Франківська область","дитячий садок ""Сонечко"", спортзал
вул.Шевченка, 18, м.Тлумач, Тлумацький р-н, Івано-Франківська обл., 78000","1776","745","1748","9","1024","7","1031","","0","1024","7","1031","23","1008","4","10","2","192","52","19","99","472","4","13","1","1","112","14","6","7","29.10.12"
"260791","84","Івано-Франківська область","школа, їдальня
вул.Хотимирська, 2А, смт Обертин, Тлумацький р-н, Івано-Франківська обл., 78060","1228","476","1222","64","692","60","752","","0","692","60","752","21","731","5","15","4","86","30","14","118","342","1","25","3","2","38","43","0","5","29.10.12"
"260792","84","Івано-Франківська область","народний дім, зал
вул.Незалежності, 11, смт Обертин, Тлумацький р-н, Івано-Франківська обл., 78060","1356","555","1335","75","732","69","801","","0","732","69","801","18","783","14","8","4","67","45","22","185","275","1","45","3","1","54","55","1","3","29.10.12"
"260793","84","Івано-Франківська область","школа, спортзал
вул.Січових Стрільців, 92, с.Гончарів, Тлумацький р-н, Івано-Франківська обл., 78060","396","127","396","24","245","24","269","","0","245","24","269","8","261","16","9","2","21","1","4","90","92","0","3","1","1","11","9","0","1","29.10.12"
"260794","84","Івано-Франківська область","народний дім, фойє
вул.Перемоги, 13, с.Бортники, Тлумацький р-н, Івано-Франківська обл., 78033","812","255","807","54","505","52","557","","0","505","52","557","10","547","13","6","9","61","9","7","110","289","2","4","0","0","29","3","3","2","29.10.12"
"260795","84","Івано-Франківська область","школа, актовий зал
вул.Гора, 28, с.Братишів, Тлумацький р-н, Івано-Франківська обл., 78014","740","171","734","51","522","47","569","","0","522","47","569","15","554","5","7","6","54","157","6","119","151","1","6","2","0","22","14","2","2","28.10.12"
"260796","84","Івано-Франківська область","клуб, зал
вул.Шевченка, 15А, с.Будзин, Тлумацький р-н, Івано-Франківська обл., 78022","640","324","629","97","229","87","316","","0","229","87","316","2","314","1","2","2","16","1","5","62","96","1","3","0","1","96","25","2","1","29.10.12"
"260797","84","Івано-Франківська область","клуб, зал
вул.І.Франка, 39, с.Одаїв, Тлумацький р-н, Івано-Франківська обл., 78022","232","78","230","40","114","40","154","","0","114","40","154","7","147","4","2","7","9","0","2","27","76","1","6","0","1","11","0","1","0","28.10.12"
"260798","84","Івано-Франківська область","клуб, зал
вул.М.Підгірянки, 79Д, с.Вікняни, Тлумацький р-н, Івано-Франківська обл., 78021","588","186","578","46","358","44","402","","0","358","44","402","3","399","6","1","2","16","79","6","53","119","1","5","2","1","89","10","7","2","29.10.12"
"260799","84","Івано-Франківська область","клуб, зал
вул.Л.Українки, 67, с.Гавриляк, Тлумацький р-н, Івано-Франківська обл., 78052","444","158","439","14","272","14","286","","0","272","14","286","18","268","2","12","2","15","0","16","150","44","0","9","1","0","6","10","0","1","28.10.12"
"260800","84","Івано-Франківська область","народний дім, фойє
вул.Шевченка, 1Б, с.Гарасимів, Тлумацький р-н, Івано-Франківська обл., 78051","1036","495","1031","58","487","54","541","","0","487","54","541","16","525","3","14","4","38","11","16","260","128","0","9","3","1","15","17","1","5","29.10.12"
"260801","84","Івано-Франківська область","клуб, зал
вул.Василенчука, 5А, с.Гостів, Тлумацький р-н, Івано-Франківська обл., 78032","748","258","747","55","435","55","490","","0","435","55","490","5","485","7","6","3","19","1","3","136","277","0","2","1","0","21","5","1","3","29.10.12"
"260802","84","Івано-Франківська область","школа, актовий зал
вул.Грушевського, 53, с.Гринівці, Тлумацький р-н, Івано-Франківська обл., 78006","924","335","908","57","533","56","589","","0","533","56","589","13","576","3","6","4","66","24","17","120","274","1","2","4","0","35","7","4","9","29.10.12"
"260803","84","Івано-Франківська область","народний дім, зал
вул.Бартки, 1А, с.Грушка, Тлумацький р-н, Івано-Франківська обл., 78043","1324","501","1310","178","647","176","823","","0","647","176","823","13","810","11","9","10","77","5","5","193","382","0","13","3","1","91","7","1","2","29.10.12"
"260804","84","Івано-Франківська область","клуб, зал
вул.Вигін, 31, с.Делева, Тлумацький р-н, Івано-Франківська обл., 78023","1320","615","1317","92","616","89","705","","0","616","89","705","9","696","4","5","8","36","38","6","230","171","2","6","0","1","177","10","0","2","29.10.12"
"260805","84","Івано-Франківська область","клуб, зал
вул.Січових Стрільців, 1Б, с.Долина, Тлумацький р-н, Івано-Франківська обл., 78024","460","153","453","67","247","60","307","","0","247","60","307","3","304","4","2","12","17","0","8","74","131","0","0","2","0","41","12","0","1","29.10.12"
"260806","84","Івано-Франківська область","школа, фойє
вул.Незалежності, 27А, с.Живачів, Тлумацький р-н, Івано-Франківська обл., 78044","824","360","817","60","404","60","464","","0","404","60","464","22","442","9","11","4","34","30","13","117","141","3","35","3","5","15","16","1","5","29.10.12"
"260807","84","Івано-Франківська область","клуб, зал
вул.Незалежності, 66, с.Жуків, Тлумацький р-н, Івано-Франківська обл., 78053","1084","447","1075","82","556","81","637","","0","556","81","637","17","620","15","9","5","75","3","6","212","219","4","8","2","0","17","43","0","2","29.10.12"
"260808","84","Івано-Франківська область","клуб, зал
вул.Шевченка, 23, с.Олещин, Тлумацький р-н, Івано-Франківська обл., 78053","196","53","194","21","128","15","143","","0","128","15","143","3","140","6","0","8","8","5","0","45","57","0","2","0","2","2","5","0","0","29.10.12"
"260809","84","Івано-Франківська область","клуб, зал
вул.І.Франка, 26, с.Ісаків, Тлумацький р-н, Івано-Франківська обл., 78042","648","176","646","42","432","40","472","","0","432","40","472","17","455","6","3","5","28","8","7","76","201","0","11","3","2","62","36","1","6","29.10.12"
"260810","84","Івано-Франківська область","школа, фойє
вул.Січових Стрільців, 4, с.Колінці, Тлумацький р-н, Івано-Франківська обл., 78005","668","205","668","51","415","48","463","","0","415","48","463","9","454","6","5","1","34","0","14","160","186","0","1","1","0","36","8","0","2","29.10.12"
"260811","84","Івано-Франківська область","школа, фойє
вул.Люлька, 1, с.Королівка, Тлумацький р-н, Івано-Франківська обл., 78030","1100","320","1093","56","730","50","780","","0","730","50","780","14","766","12","3","8","278","6","15","166","199","3","3","13","0","51","8","1","0","29.10.12"
"260812","84","Івано-Франківська область","народний дім, зал
вул.Центральна, 87В, с.Кутище, Тлумацький р-н, Івано-Франківська обл., 78020","1076","414","1067","97","567","95","662","","0","567","95","662","30","632","5","8","8","43","50","6","135","267","1","6","3","3","46","16","28","7","29.10.12"
"260813","84","Івано-Франківська область","школа, актовий зал
вул.Гостинець, 37, с.Надорожна, Тлумацький р-н, Івано-Франківська обл., 78016","772","264","767","47","464","44","508","","0","464","44","508","13","495","5","1","5","29","23","72","185","128","1","3","2","1","26","11","1","2","29.10.12"
"260814","84","Івано-Франківська область","народний дім, фойє
вул.Дністерська, 14А, с.Нижнів, Тлумацький р-н, Івано-Франківська обл., 78013","1772","610","1749","112","1050","112","1162","","0","1050","112","1162","33","1129","8","9","10","109","29","6","178","608","14","8","1","4","79","60","5","1","29.10.12"
"260815","84","Івано-Франківська область","школа, їдальня
вул.Центральна, 9, с.Озеряни, Тлумацький р-н, Івано-Франківська обл., 78045","416","129","417","48","239","48","287","","0","239","48","287","8","279","6","3","10","31","4","8","68","102","0","1","2","1","20","17","3","3","29.10.12"
"260816","84","Івано-Франківська область","народний дім, актовий зал
вул.Грушевського, 123, с.Олеша, Тлумацький р-н, Івано-Франківська обл., 78040","772","252","765","57","464","56","520","","0","464","56","520","9","511","5","6","2","31","33","15","55","333","1","2","2","1","18","2","5","0","29.10.12"
"260817","84","Івано-Франківська область","сільська рада, зал засідань
вул.Грушевського, 121, с.Олеша, Тлумацький р-н, Івано-Франківська обл., 78040","680","193","676","64","423","64","487","","0","423","64","487","6","481","5","6","7","20","27","7","98","267","0","5","1","1","18","9","6","4","29.10.12"
"260818","84","Івано-Франківська область","школа, фойє
вул.Центральна, 25А, с.Олешів, Тлумацький р-н, Івано-Франківська обл., 78011","492","145","479","48","299","48","347","","0","299","48","347","5","342","2","5","1","28","6","4","73","181","0","4","6","0","15","16","0","1","29.10.12"
"260819","84","Івано-Франківська область","школа, каб.2
вул.Шевченка, 45А, с.Буківна, Тлумацький р-н, Івано-Франківська обл., 78011","204","39","208","20","147","18","165","","0","147","18","165","6","159","4","3","3","10","11","4","28","81","0","2","0","0","11","1","0","1","29.10.12"
"260820","84","Івано-Франківська область","школа, спортивна кімната
вул.Підгірянки, 42А, с.Антонівка, Тлумацький р-н, Івано-Франківська обл., 78011","220","104","223","26","91","25","116","","0","91","25","116","1","115","2","1","0","17","0","3","36","49","0","1","0","0","4","2","0","0","29.10.12"
"260821","84","Івано-Франківська область","школа, фойє
вул.Братів Саракунових, 5, с.Остриня, Тлумацький р-н, Івано-Франківська обл., 78012","664","206","659","66","399","59","458","","0","399","59","458","4","454","11","4","2","56","91","4","121","91","3","5","1","0","34","28","2","1","29.10.12"
"260822","84","Івано-Франківська область","народний дім, зал
вул.Шевченка, 4А, с.Палагичі, Тлумацький р-н, Івано-Франківська обл., 78015","940","307","930","87","557","76","633","","0","557","76","633","12","621","3","8","2","26","15","4","80","326","0","3","5","3","120","25","1","0","29.10.12"
"260823","84","Івано-Франківська область","клуб, зал
вул.Центральна, 35А, с.Локітка, Тлумацький р-н, Івано-Франківська обл., 78015","472","154","468","30","291","27","318","","0","291","27","318","9","309","4","2","0","32","2","10","59","133","1","3","0","1","48","4","5","5","29.10.12"
"260824","84","Івано-Франківська область","клуб, зал
вул.Церковна, 8А, с.Попелів, Тлумацький р-н, Івано-Франківська обл., 78015","204","54","209","12","139","11","150","","0","139","11","150","5","145","2","4","2","11","4","4","19","81","1","3","0","0","9","1","2","2","29.10.12"
"260825","84","Івано-Франківська область","клуб, зал
вул.Центральна, 51А, с.Гончарівка, Тлумацький р-н, Івано-Франківська обл., 78015","364","103","368","33","228","33","261","","0","228","33","261","4","257","0","3","1","60","5","3","21","117","1","5","1","1","23","2","4","10","29.10.12"
"260826","84","Івано-Франківська область","школа, фойє
вул.Незалежності, 31, с.Петрилів, Тлумацький р-н, Івано-Франківська обл., 78010","608","199","591","55","356","53","409","","0","356","53","409","5","404","6","4","1","31","0","6","87","230","11","4","1","0","5","16","1","1","29.10.12"
"260827","84","Івано-Франківська область","клуб, зал
вул.Л.Українки, 24, с.Новосілка, Тлумацький р-н, Івано-Франківська обл., 78010","112","25","110","19","69","18","87","","0","69","18","87","1","86","7","3","0","1","0","3","3","52","0","2","0","0","9","5","0","1","29.10.12"
"260828","84","Івано-Франківська область","клуб, зал
вул.Тернопільська, 2, с.Діброва, Тлумацький р-н, Івано-Франківська обл., 78010","216","52","211","41","127","37","164","","0","127","37","164","5","159","2","2","3","14","2","1","20","84","0","0","0","2","19","7","2","1","29.10.12"
"260829","84","Івано-Франківська область","сільська рада, кімната засідань
вул.Незалежності, 1, с.Петрів, Тлумацький р-н, Івано-Франківська обл., 78041","616","173","614","81","362","81","443","","0","362","81","443","3","440","5","0","3","21","4","1","93","272","0","2","0","2","30","5","1","1","29.10.12"
"260830","84","Івано-Франківська область","клуб, зал
вул.Незалежності, 4, с.Сокирчин, Тлумацький р-н, Івано-Франківська обл., 78041","372","122","369","26","224","26","250","","0","224","26","250","3","247","0","6","4","17","1","1","22","146","1","1","1","2","29","7","2","7","29.10.12"
"260831","84","Івано-Франківська область","школа, актовий зал
вул.Шевченка, 76А, с.Підвербці, Тлумацький р-н, Івано-Франківська обл., 78046","544","156","541","52","345","43","388","","0","345","43","388","11","377","5","3","6","35","3","6","73","195","0","5","3","1","38","3","1","0","29.10.12"
"260832","84","Івано-Франківська область","школа, фойє
вул.І.Франка, 7, с.Прибилів, Тлумацький р-н, Івано-Франківська обл., 78031","748","315","741","45","389","44","433","","0","389","44","433","12","421","11","4","1","17","4","5","181","172","1","3","0","1","13","5","3","0","29.10.12"
"260833","84","Івано-Франківська область","клуб, зал
вул.Миру, 1, с.Пужники, Тлумацький р-н, Івано-Франківська обл., 78034","632","247","625","58","328","57","385","","0","328","57","385","14","371","3","16","5","34","4","8","76","195","0","3","5","3","10","7","1","1","29.10.12"
"260834","84","Івано-Франківська область","сільська рада, кімната засідань
вул.Шевченка, 4, с.Тарасівка, Тлумацький р-н, Івано-Франківська обл., 78063","264","97","264","21","148","19","167","","0","148","19","167","6","161","3","5","6","10","0","2","36","71","2","2","2","0","14","2","1","5","29.10.12"
"260835","84","Івано-Франківська область","клуб, зал
вул.Осередок, 15, с.Хотимир, Тлумацький р-н, Івано-Франківська обл., 78050","612","219","606","63","333","60","393","","0","333","60","393","11","382","8","4","7","39","8","8","75","182","4","7","5","1","11","21","0","2","29.10.12"
"260836","84","Івано-Франківська область","клуб, зал
вул.Хотимирська, 68, с.Жабокруки, Тлумацький р-н, Івано-Франківська обл., 78050","304","110","295","19","176","18","194","","0","176","18","194","8","186","3","1","1","15","0","13","67","34","0","0","4","2","13","9","0","24","29.10.12"
"260837","84","Івано-Франківська область","клуб, фойє
вул.Центральна, 1В, с.Яківка, Тлумацький р-н, Івано-Франківська обл., 78064","1116","443","1106","54","622","51","673","","0","622","51","673","26","647","8","4","5","79","14","10","219","217","2","14","0","2","35","36","2","0","29.10.12"
"260838","84","Івано-Франківська область","Тлумацька центральна районна лікарня, хол корпусу №1
вул.Винниченка, 84, м.Тлумач, Тлумацький р-н, Івано-Франківська обл., 78000","152","57","102","38","59","36","95","","0","59","36","95","0","95","1","6","2","7","0","2","11","51","0","1","1","0","11","0","0","2","29.10.12"
"260885","84","Івано-Франківська область","Вовчинецька школа, фойє
вул.Гайова, 10, с.Вовчинець, м.Івано-Франківськ, 76000","464","246","471","1","217","1","218","","0","217","1","218","6","212","3","7","1","58","4","3","28","76","0","11","1","3","9","5","2","1","28.10.12"
"260886","84","Івано-Франківська область","будинок культури, актова зала
вул.Вовчинецька, 35, с.Вовчинець, м.Івано-Франківськ, 76491","2404","863","2380","23","1522","19","1541","","0","1522","19","1541","41","1500","17","15","8","262","19","11","151","871","2","36","23","3","22","44","4","12","29.10.12"
"260908","84","Івано-Франківська область","Народний дім, актова зала
вул.Зарічна, 75А, с.Микитинці, м.Івано-Франківськ, 76494","2124","737","2104","50","1351","36","1387","","0","1351","36","1387","40","1347","9","19","19","170","32","10","169","818","3","8","19","1","38","23","4","5","29.10.12"
"260909","84","Івано-Франківська область","ліцей автотранспорту і будівництва, актова зала
вул.Юності, 7, с.Микитинці, м.Івано-Франківськ, 76494","724","325","707","0","399","0","399","","0","399","0","399","11","388","12","3","5","72","9","3","33","201","2","6","6","4","16","5","2","9","29.10.12"
"260910","84","Івано-Франківська область","Народний дім, зал
вул.Повстанців, 100, с.Угорники, м.Івано-Франківськ, 76492","2512","826","2489","41","1649","37","1686","","0","1649","37","1686","40","1646","23","9","17","204","41","14","204","958","4","17","31","3","97","10","2","12","29.10.12"
"260918","84","Івано-Франківська область","Народний дім с.Хриплин, актова зала
вул.Берегова, 4В, с.Хриплин, м.Івано-Франківськ, 76493","1564","585","1548","27","952","27","979","","0","952","27","979","19","960","6","7","6","109","10","4","113","618","4","6","10","1","27","22","7","10","29.10.12"
"260944","84","Івано-Франківська область","Крихівецька школа, спортивний зал
вул.22 Січня, 141А, с.Крихівці, м.Івано-Франківськ, 76493","2320","851","2299","33","1440","29","1469","","0","1440","29","1469","47","1422","17","28","8","210","22","15","168","817","12","12","21","5","45","27","3","12","29.10.12"
"260945","84","Івано-Франківська область","Народний дім, актова зала
вул.Криховецька, 1В, с.Крихівці, м.Івано-Франківськ, 76493","1676","567","1664","18","1095","14","1109","","0","1095","14","1109","45","1064","15","25","4","147","14","5","110","654","8","10","25","8","16","12","2","9","29.10.12"
