"№ ВД","OBO","Назва регіону України","Місцезнаходження та адреса приміщення для голосування","1) К-сть одержаних бюлетенів","2) К-сть невикористаних бюлетенів","3) К-сть виборців, внесених до списку виборців","4) К-сть виборців, внесених до витягу зі списку виборців","5) К-сть виборців, які отримали бюлетені у приміщенні","6) К-сть виборців, які отримали за місцем перебування","7) Сумарна к-сть виборців, які отримали бюлетені","8) К-сть бюлетенів, що виявилися у кожній скринці","9) К-сть бюлетенів, що не підлягають врахуванню","10) К-сть виборців, які взяли участь у голос. у приміщенні для гол.","11) К-сть виборців, які взяли участь у голос. за місцем перебування","12) К-сть виборців, які взяли участь у голосуванні на виборчій дільниці","13) К-сть бюлетенів, визнаних недійсними","14) Сумарна к-сть голосів виборців ЗА","Апостол
Михайло
Володимирович","Давиденко
Андрій
Анатолійович","Люшняк
Микола
Володимирович","Півторак
Роман
Євстахійович","Савчук
Михайло
Дмитрович","Стецюк
Тетяна
Іванівна","Хоптян
Надія
Андріївна","Дата підписання протоколу"
"610132","166","Тернопільська область","сільська рада, зал засідань
вул.Місто, 16, с.Бариш, Бучацький р-н, Тернопільська обл., 48424","744","173","756","52","523","48","571","","0","523","48","571","10","561","289","77","124","5","4","1","61","29.10.12"
"610133","166","Тернопільська область","будинок культури, танцювальний зал
вул.Місто, 36, с.Бариш, Бучацький р-н, Тернопільська обл., 48424","880","272","870","46","564","44","608","","0","564","44","608","15","593","381","66","108","2","4","5","27","29.10.12"
"610134","166","Тернопільська область","сільський клуб, глядацький зал
вул.Гутишино, 27, с.Бариш, Бучацький р-н, Тернопільська обл., 48424","128","35","128","11","83","10","93","","0","83","10","93","2","91","45","13","26","0","1","1","5","29.10.12"
"610135","166","Тернопільська область","сільський клуб, глядацький зал
вул.Центральна, 52, с.Берем’яни, Бучацький р-н, Тернопільська обл., 48464","512","168","507","54","291","53","344","","0","291","53","344","17","327","82","109","61","5","6","7","57","29.10.12"
"610136","166","Тернопільська область","будинок культури, глядацький зал
вул.Центральна, 3, с.Бобулинці, Бучацький р-н, Тернопільська обл., 48472","552","144","545","33","376","32","408","","0","376","32","408","9","399","92","167","82","3","2","2","51","29.10.12"
"610137","166","Тернопільська область","філія ""Бучацький райавтодор"", актова зала
вул.Генерала Шухевича, 61, м.Бучач, Бучацький р-н, Тернопільська обл., 48400","400","131","392","2","267","2","269","","0","267","2","269","20","249","83","47","89","0","7","7","16","30.10.12"
"610138","166","Тернопільська область","школа №3, актова зала
вул.Дорошенка, 4, м.Бучач, Бучацький р-н, Тернопільська обл., 48400","1032","355","1007","30","647","30","677","","0","647","30","677","11","666","311","123","172","0","19","4","37","28.10.12"
"610139","166","Тернопільська область","бібліотека, фойє
вул.Галицька, 21, м.Бучач, Бучацький р-н, Тернопільська обл., 48400","1272","449","1247","35","788","35","823","","0","788","35","823","18","805","352","147","230","4","19","17","36","29.10.12"
"610140","166","Тернопільська область","будинок культури, глядацький зал №2
вул.Шкільна, 8, м.Бучач, Бучацький р-н, Тернопільська обл., 48400","1192","456","1170","34","705","31","736","","0","705","31","736","13","723","305","140","199","11","11","4","53","29.10.12"
"610141","166","Тернопільська область","Бучацький лісозавод, актова зала
вул.Галицька, 145, м.Бучач, Бучацький р-н, Тернопільська обл., 48400","776","242","766","20","515","19","534","","0","515","19","534","13","521","216","102","171","3","8","0","21","29.10.12"
"610142","166","Тернопільська область","Бучацьке лісове господарство, актова зала
вул.Степана Бандери, 12, м.Бучач, Бучацький р-н, Тернопільська обл., 48400","1896","643","1869","35","1223","30","1253","","0","1223","30","1253","45","1208","525","230","350","9","24","14","56","29.10.12"
"610143","166","Тернопільська область","школа, актова зала
вул.П.Тичини, 13, м.Бучач, Бучацький р-н, Тернопільська обл., 48400","1056","398","1055","37","624","34","658","","0","624","34","658","14","644","334","155","125","6","3","2","19","29.10.12"
"610144","166","Тернопільська область","Бучацький інститут менеджменту і аудиту, актова зала
вул.Богдана Хмельницького, 25, м.Бучач, Бучацький р-н, Тернопільська обл., 48400","912","310","898","23","580","22","602","","0","580","22","602","25","577","299","99","144","2","8","2","23","29.10.12"
"610145","166","Тернопільська область","міський клуб, глядацький зал
вул.Підгаєцька, 158, м.Бучач, Бучацький р-н, Тернопільська обл., 48400","864","262","859","23","583","19","602","","0","583","19","602","15","587","274","151","117","3","10","4","28","28.10.12"
"610146","166","Тернопільська область","сільський клуб, глядацький зал
вул.Івана Франка, 41, с.Возилів, Бучацький р-н, Тернопільська обл., 48456","640","201","639","54","385","54","439","","0","385","54","439","14","425","188","62","88","2","33","4","48","28.10.12"
"610147","166","Тернопільська область","сільський клуб, глядацький зал
вул.Наддністрянська, 18, с.Возилів, Бучацький р-н, Тернопільська обл., 48456","232","67","227","27","139","26","165","","0","139","26","165","3","162","54","33","56","1","5","0","13","29.10.12"
"610148","166","Тернопільська область","будинок культури, глядацький зал
вул.Шупарка, 3, с.Доброполе, Бучацький р-н, Тернопільська обл., 48410","448","125","445","41","284","39","323","","0","284","39","323","13","310","114","127","37","1","3","2","26","29.10.12"
"610149","166","Тернопільська область","сільський клуб, глядацький зал
вул.Центральна, 6, с.Матеушівка, Бучацький р-н, Тернопільська обл., 48410","128","25","121","12","91","12","103","","0","91","12","103","2","101","44","21","20","0","1","0","15","29.10.12"
"610150","166","Тернопільська область","сільський клуб, глядацький зал
вул.Центральна, 49, с.Дуліби, Бучацький р-н, Тернопільська обл., 48473","640","97","629","22","523","20","543","","0","523","20","543","17","526","187","158","52","1","12","4","112","29.10.12"
"610151","166","Тернопільська область","школа, спортивний зал
вул.Т.Г.Шевченка, 136, с.Жизномир, Бучацький р-н, Тернопільська обл., 48432","1240","371","1234","72","801","68","869","","0","801","68","869","27","842","460","190","116","3","17","6","50","29.10.12"
"610152","166","Тернопільська область","сільський клуб, глядацький зал
вул.Ковалівка, 7, с.Жнибороди, Бучацький р-н, Тернопільська обл., 48474","512","57","508","39","416","39","455","","0","416","39","455","2","453","148","149","40","0","5","0","111","29.10.12"
"610153","166","Тернопільська область","сільський клуб, глядацький зал
вул.Горішня, 72, с.Заривинці, Бучацький р-н, Тернопільська обл., 48475","448","108","449","28","314","26","340","","0","314","26","340","14","326","167","52","40","5","1","1","60","29.10.12"
"610154","166","Тернопільська область","сільський клуб, глядацький зал
вул.Клубна, 3, с.Рукомиш, Бучацький р-н, Тернопільська обл., 48420","344","60","335","29","255","29","284","","0","255","29","284","12","272","62","44","56","4","6","3","97","28.10.12"
"610155","166","Тернопільська область","сільський клуб, глядацький зал
вул.Середня, 36А, с.Зелена, Бучацький р-н, Тернопільська обл., 48476","552","127","537","24","403","22","425","","0","403","22","425","21","404","116","42","59","0","0","0","187","29.10.12"
"610156","166","Тернопільська область","школа, спортивний зал
вул.Зелена, 2, смт Золотий Потік, Бучацький р-н, Тернопільська обл., 48451","1840","646","1819","81","1119","75","1194","","0","1119","75","1194","36","1158","570","235","178","8","65","16","86","29.10.12"
"610157","166","Тернопільська область","фельдшерсько-акушерський пункт, маніпуляційний кабінет
вул.Шкільна, 7, с.Рублин, Бучацький р-н, Тернопільська обл., 48452","208","73","207","3","132","3","135","","0","132","3","135","7","128","47","30","36","1","2","3","9","29.10.12"
"610158","166","Тернопільська область","сільський клуб, глядацький зал
вул.Центральна, 32, с.Зубрець, Бучацький р-н, Тернопільська обл., 48441","1136","417","1122","89","631","88","719","","0","631","88","719","29","690","352","164","143","2","6","1","22","29.10.12"
"610159","166","Тернопільська область","сільський клуб, глядацький зал
вул.Центральна, 42, с.Киданів, Бучацький р-н, Тернопільська обл., 48412","224","69","221","17","142","13","155","","0","142","13","155","4","151","39","47","24","1","1","0","39","29.10.12"
"610160","166","Тернопільська область","сільський клуб, глядацький зал
вул.Дружби, 21, с.Космирин, Бучацький р-н, Тернопільська обл., 48454","632","278","631","41","313","41","354","","0","313","41","354","17","337","137","75","68","6","4","2","45","29.10.12"
"610161","166","Тернопільська область","школа, каб.2
вул.Горішня, 34, с.Набережне, Бучацький р-н, Тернопільська обл., 48454","184","52","181","10","122","10","132","","0","122","10","132","8","124","101","3","10","2","1","2","5","29.10.12"
"610162","166","Тернопільська область","сільський клуб, глядацький зал
вул.Макухова, 29, с.Костільники, Бучацький р-н, Тернопільська обл., 48463","768","220","757","59","492","56","548","","0","492","56","548","38","510","175","138","84","6","37","11","59","29.10.12"
"610163","166","Тернопільська область","сільський клуб, глядацький зал
вул.Квасниці, 27, с.Ліщанці, Бучацький р-н, Тернопільська обл., 48442","784","213","776","67","507","64","571","","0","507","64","571","22","549","145","132","141","6","15","13","97","29.10.12"
"610164","166","Тернопільська область","сільський клуб, глядацький зал
вул.Центральна, 30, с.Миколаївка, Бучацький р-н, Тернопільська обл., 48465","400","118","387","41","241","41","282","","0","241","41","282","7","275","51","122","50","2","19","4","27","29.10.12"
"610165","166","Тернопільська область","сільський клуб, глядацький зал
вул.Головна, 34А, с.Губин, Бучацький р-н, Тернопільська обл., 48465","144","50","138","9","86","8","94","","0","86","8","94","2","92","31","22","10","0","2","1","26","29.10.12"
"610166","166","Тернопільська область","сільський клуб, глядацький зал
вул.Горішня, 32, с.Сокілець, Бучацький р-н, Тернопільська обл., 48465","200","70","194","15","116","14","130","","0","116","14","130","7","123","33","29","27","3","2","2","27","29.10.12"
"610167","166","Тернопільська область","сільський клуб, глядацький зал
вул.Центральна, 4А, с.Медведівці, Бучацький р-н, Тернопільська обл., 48477","992","288","980","31","673","31","704","","0","673","31","704","23","681","305","159","81","4","8","8","116","29.10.12"
"610168","166","Тернопільська область","будинок культури, глядацький зал
вул.Фільвароцька, 72, с.Нові Петликівці, Бучацький р-н, Тернопільська обл., 48411","512","123","507","29","361","28","389","","0","361","28","389","4","385","152","113","64","1","2","2","51","29.10.12"
"610169","166","Тернопільська область","сільський клуб, глядацький зал
вул.Долішня, 25, с.Пушкарі, Бучацький р-н, Тернопільська обл., 48468","104","28","100","6","70","6","76","","0","70","6","76","3","73","23","13","18","1","1","2","15","28.10.12"
"610170","166","Тернопільська область","будинок культури, глядацький зал
вул.Переволоцька, 59, с.Озеряни, Бучацький р-н, Тернопільська обл., 48422","824","273","822","42","512","39","551","","0","512","39","551","15","536","170","201","96","2","9","6","52","29.10.12"
"610171","166","Тернопільська область","сільський клуб, глядацький зал
вул.Л.Українки, 64, с.Верб’ятин, Бучацький р-н, Тернопільська обл., 48422","264","85","257","9","171","8","179","","0","171","8","179","8","171","79","34","31","2","1","2","22","29.10.12"
"610172","166","Тернопільська область","сільський клуб, глядацький зал
вул.Центральна, 76, с.Осівці, Бучацький р-н, Тернопільська обл., 48412","728","222","720","35","472","34","506","","0","472","34","506","16","490","163","169","117","1","6","1","33","29.10.12"
"610173","166","Тернопільська область","сільський клуб, глядацький зал
вул.Шкільна, 21, с.Переволока, Бучацький р-н, Тернопільська обл., 48420","576","171","561","28","379","26","405","","0","379","26","405","14","391","165","95","75","4","2","4","46","29.10.12"
"610174","166","Тернопільська область","будинок культури, глядацький зал
вул.Купрійова, 2, с.Переволока, Бучацький р-н, Тернопільська обл., 48420","1192","348","1174","78","766","78","844","","0","766","78","844","23","821","272","244","195","5","11","4","90","29.10.12"
"610175","166","Тернопільська область","будинок культури, фойє
вул.Сонячна, 7, с.Передмістя, Бучацький р-н, Тернопільська обл., 48467","264","79","260","10","177","8","185","","0","177","8","185","5","180","53","54","54","1","4","1","13","29.10.12"
"610176","166","Тернопільська область","будинок культури, фойє
вул.Центральна, 79, с.Заліщики, Бучацький р-н, Тернопільська обл., 48467","360","68","356","26","268","24","292","","0","268","24","292","4","288","106","57","29","2","6","7","81","29.10.12"
"610177","166","Тернопільська область","сільська рада, зал засідань
вул.Центральна, 70, с.Пилява, Бучацький р-н, Тернопільська обл., 48414","360","111","355","22","227","22","249","","0","227","22","249","8","241","123","32","30","0","1","3","52","29.10.12"
"610178","166","Тернопільська область","школа, спортивний зал
вул.Центральна, 92, с.Новоставці, Бучацький р-н, Тернопільська обл., 48478","656","149","648","40","467","40","507","","0","467","40","507","17","490","268","92","46","1","3","3","77","29.10.12"
"610179","166","Тернопільська область","сільський клуб, глядацький зал
вул.Войтихівка, 88, с.Мартинівка, Бучацький р-н, Тернопільська обл., 48414","240","65","234","18","157","18","175","","0","157","18","175","4","171","85","16","42","1","0","2","25","29.10.12"
"610180","166","Тернопільська область","сільський клуб, глядацький зал
вул.Шевченка, 87, с.Пишківці, Бучацький р-н, Тернопільська обл., 48430","1000","155","1004","42","805","40","845","","0","805","40","845","22","823","314","222","247","3","9","6","22","29.10.12"
"610181","166","Тернопільська область","сільський клуб, глядацький зал
вул.Тернопільська, 71, с.Підзамочок, Бучацький р-н, Тернопільська обл., 48423","1264","402","1240","53","809","53","862","","0","809","53","862","23","839","381","158","175","2","9","6","108","29.10.12"
"610182","166","Тернопільська область","сільський клуб, глядацький зал
вул.Центральна, 56, с.Звенигород, Бучацький р-н, Тернопільська обл., 48421","632","82","620","25","525","25","550","","0","525","25","550","9","541","225","185","62","1","2","1","65","29.10.12"
"610183","166","Тернопільська область","сільський клуб, глядацький зал
вул.Л.Українки, 81, с.Підлісся, Бучацький р-н, Тернопільська обл., 48423","328","92","321","17","219","17","236","","0","219","17","236","6","230","116","35","62","0","2","9","6","29.10.12"
"610184","166","Тернопільська область","школа, актова зала
вул.Центральна, 5, с.Порохова, Бучацький р-н, Тернопільська обл., 48443","856","344","839","83","430","82","512","","0","430","82","512","22","490","128","97","144","3","14","21","83","29.10.12"
"610185","166","Тернопільська область","будинок культури, глядацький зал
вул.Центральна, 27, с.Ріпинці, Бучацький р-н, Тернопільська обл., 48433","856","243","839","73","541","72","613","","0","541","72","613","22","591","170","171","103","9","5","3","130","29.10.12"
"610186","166","Тернопільська область","школа, фойє
вул.Центральна, 22Б, с.Русилів, Бучацький р-н, Тернопільська обл., 48444","232","68","231","8","156","8","164","","0","156","8","164","2","162","21","80","20","0","1","3","37","29.10.12"
"610187","166","Тернопільська область","будинок культури, глядацький зал
вул.Центральна, 101А, с.Скоморохи, Бучацький р-н, Тернопільська обл., 48462","848","220","846","28","600","28","628","","0","600","28","628","11","617","240","180","88","11","19","8","71","28.10.12"
"610188","166","Тернопільська область","будинок культури, глядацький зал
вул.Гостинець, 22, с.Сновидів, Бучацький р-н, Тернопільська обл., 48455","1384","583","1369","110","695","106","801","","0","695","106","801","23","778","386","171","121","4","26","4","66","29.10.12"
"610189","166","Тернопільська область","школа, фойє
вул.Шкільна, 29, с.Соколів, Бучацький р-н, Тернопільська обл., 48444","1392","365","1373","47","980","47","1027","","0","980","47","1027","33","994","366","234","245","7","15","13","114","29.10.12"
"610190","166","Тернопільська область","сільський клуб, глядацький зал
вул.Центральна, 14, с.Сороки, Бучацький р-н, Тернопільська обл., 48440","960","136","953","37","787","37","824","","0","787","37","824","38","786","278","135","150","1","13","20","189","30.10.12"
"610191","166","Тернопільська область","сільський клуб, глядацький зал
вул.Застрипна, 20, с.Старі Петликівці, Бучацький р-н, Тернопільська обл., 48413","768","191","759","70","509","68","577","","0","509","68","577","16","561","212","138","95","4","3","3","106","29.10.12"
"610192","166","Тернопільська область","сільський клуб, глядацький зал
вул.Горішня, 3, с.Білявинці, Бучацький р-н, Тернопільська обл., 48471","456","102","443","37","317","37","354","","0","317","37","354","8","346","85","129","57","3","9","5","58","29.10.12"
"610193","166","Тернопільська область","школа, актова зала
вул.Центральна, 24, с.Стінка, Бучацький р-н, Тернопільська обл., 48450","1528","702","1518","90","745","81","826","","0","745","81","826","56","770","322","212","137","7","25","11","56","29.10.12"
"610194","166","Тернопільська область","сільський клуб, глядацький зал
вул.Бічна, 29, с.Млинки, Бучацький р-н, Тернопільська обл., 48450","216","57","207","15","145","14","159","","0","145","14","159","12","147","73","17","10","1","5","6","35","29.10.12"
"610195","166","Тернопільська область","Бучацький коледж Подільського державного аграрно-технічного університету, актова зала
вул.Винниченка, 4, с.Трибухівці, Бучацький р-н, Тернопільська обл., 48431","880","330","860","10","542","8","550","","0","542","8","550","13","537","221","150","127","2","9","4","24","29.10.12"
"610196","166","Тернопільська область","будинок культури, вестибюль
вул.Грушевського, 3, с.Трибухівці, Бучацький р-н, Тернопільська обл., 48431","1048","441","1033","27","581","26","607","","0","581","26","607","17","590","257","151","133","2","5","4","38","29.10.12"
"610197","166","Тернопільська область","школа, їдальня
вул.Грушевського, 1, с.Трибухівці, Бучацький р-н, Тернопільська обл., 48431","1160","401","1144","35","726","33","759","","0","726","33","759","34","725","272","245","158","2","6","4","38","29.10.12"
"610198","166","Тернопільська область","сільський клуб, глядацький зал
вул.Ринок, 16, с.Цвітова, Бучацький р-н, Тернопільська обл., 48480","472","136","468","32","305","31","336","","0","305","31","336","15","321","78","133","52","1","1","7","49","29.10.12"
"610199","166","Тернопільська область","будинок культури, фойє
вул.Центральна, 25, с.Язловець, Бучацький р-н, Тернопільська обл., 48467","440","143","438","39","258","39","297","","0","258","39","297","3","294","126","55","75","0","5","0","33","29.10.12"
"610200","166","Тернопільська область","сільський клуб, глядацький зал
вул.Шевченка, 27, с.Броварі, Бучацький р-н, Тернопільська обл., 48467","264","77","258","24","163","24","187","","0","163","24","187","8","179","50","44","41","1","3","0","40","29.10.12"
"610201","166","Тернопільська область","сільський клуб, глядацький зал
вул.Церковна, 1, с.Новосілка, Бучацький р-н, Тернопільська обл., 48461","408","126","404","31","253","29","282","","0","253","29","282","11","271","71","147","34","1","3","1","14","29.10.12"
"610202","166","Тернопільська область","Поліклінічне відділення Бучацької центральної комунальної районної лікарні, зала засідань
вул.Галицька, 40, м.Бучач, Тернопільська обл., 48400","56","25","47","27","18","13","31","","0","18","13","31","4","27","5","3","4","0","0","1","14","29.10.12"
"610203","166","Тернопільська область","фельдшерсько-акушерський пункт, к.1
вул.Троянівська, 5, с.Боднарівка, Гусятинський р-н, Тернопільська обл., 48207","104","20","99","13","71","13","84","","0","71","13","84","1","83","17","33","3","0","6","1","23","29.10.12"
"610204","166","Тернопільська область","сільський клуб, концертний зал
вул.Грушевського, 2, с.Буцики, Гусятинський р-н, Тернопільська обл., 48210","320","59","317","14","248","13","261","","0","248","13","261","5","256","78","68","60","2","10","1","37","29.10.12"
"610205","166","Тернопільська область","будинок культури, фойє
вул.Незалежності, 32, с.Васильківці, Гусятинський р-н, Тернопільська обл., 48257","1048","327","1040","70","651","70","721","","0","651","70","721","26","695","193","318","90","3","12","3","76","29.10.12"
"610206","166","Тернопільська область","сільський клуб, концертний зал
вул.Грушевського, 42, с.Верхівці, Гусятинський р-н, Тернопільська обл., 48245","336","70","334","25","241","25","266","","0","241","25","266","8","258","65","66","84","4","4","0","35","29.10.12"
"610207","166","Тернопільська область","сільський клуб, каб.1
вул.Підлісна, 55А, с.Вигода, Гусятинський р-н, Тернопільська обл., 48273","144","26","140","6","112","6","118","","0","112","6","118","3","115","63","18","12","1","3","1","17","29.10.12"
"610208","166","Тернопільська область","сільський клуб, концертний зал
вул.Набережна, 54, с.Волиця, Гусятинський р-н, Тернопільська обл., 48233","224","71","217","26","130","23","153","","0","130","23","153","7","146","43","38","15","0","6","3","41","29.10.12"
"610209","166","Тернопільська область","будинок культури, концертний зал
вул.Центральна, 136А, с.Вікно, Гусятинський р-н, Тернопільська обл., 48217","888","304","869","56","528","56","584","","0","528","56","584","20","564","161","196","112","11","4","1","79","29.10.12"
"610210","166","Тернопільська область","сільська рада, кабінет голови
вул.І.Франка, 19, с.Вільхівчик, Гусятинський р-н, Тернопільська обл., 48254","496","118","492","29","349","29","378","","0","349","29","378","8","370","128","128","49","5","16","4","40","29.10.12"
"610211","166","Тернопільська область","школа, фойє
вул.Залізнична, 8, с.Гадинківці, Гусятинський р-н, Тернопільська обл., 48273","760","237","753","72","454","69","523","","0","454","69","523","11","512","314","94","17","2","8","0","77","29.10.12"
"610212","166","Тернопільська область","будинок культури, фойє
вул.Центральна, 1, с.Глібів, Гусятинський р-н, Тернопільська обл., 48216","736","244","730","68","428","64","492","","0","428","64","492","17","475","118","149","108","2","46","1","51","29.10.12"
"610213","166","Тернопільська область","будинок культури, концертний зал
пл.І.Пулюя, 1, смт Гримайлів, Гусятинський р-н, Тернопільська обл., 48210","1528","542","1513","79","914","72","986","","0","914","72","986","20","966","308","158","189","5","125","11","170","29.10.12"
"610214","166","Тернопільська область","будинок культури, танцювальний зал
вул.Центральна, 330Б, с.Городниця, Гусятинський р-н, Тернопільська обл., 48237","1208","291","1198","100","820","97","917","","0","820","97","917","31","886","354","203","241","5","30","3","50","29.10.12"
"610215","166","Тернопільська область","будинок культури, танцювальний зал
вул.Наливайка, 2, смт Гусятин, Гусятинський р-н, Тернопільська обл., 48201","2504","865","2492","28","1616","23","1639","","0","1616","23","1639","25","1614","400","381","214","12","325","20","262","29.10.12"
"610216","166","Тернопільська область","школа, фойє
вул.Шевченка, 2, смт Гусятин, Гусятинський р-н, Тернопільська обл., 48201","2512","875","2486","14","1623","14","1637","","0","1623","14","1637","33","1604","447","371","244","10","334","12","186","29.10.12"
"610217","166","Тернопільська область","будинок культури, танцювальний зал
вул.Центральна, 191, с.Жабинці, Гусятинський р-н, Тернопільська обл., 48271","464","99","460","45","321","44","365","","0","321","44","365","5","360","186","71","39","2","22","1","39","29.10.12"
"610218","166","Тернопільська область","сільський клуб, каб.1
вул.Заремба Підлісна, 50А, с.Вигода, Гусятинський р-н, Тернопільська обл., 48273","72","17","68","13","43","12","55","","0","43","12","55","1","54","22","10","3","0","0","1","18","29.10.12"
"610219","166","Тернопільська область","сільський клуб, концертний зал
вул.Центральна, 46, с.Зелене, Гусятинський р-н, Тернопільська обл., 48230","328","67","321","21","240","21","261","","0","240","21","261","6","255","34","132","26","0","8","1","54","29.10.12"
"610220","166","Тернопільська область","сільський клуб, концертний зал
вул.Сатанівська, 27, с.Калагарівка, Гусятинський р-н, Тернопільська обл., 48233","472","124","468","56","292","56","348","","0","292","56","348","9","339","103","134","38","1","14","4","45","29.10.12"
"610221","166","Тернопільська область","сільський клуб, концертний зал
вул.Міцкевича, 1, с.Карашинці, Гусятинський р-н, Тернопільська обл., 48240","392","103","386","28","261","28","289","","0","261","28","289","5","284","69","157","36","0","3","1","18","29.10.12"
"610222","166","Тернопільська область","школа, фойє
вул.Шкільна, 3, с.Клювинці, Гусятинський р-н, Тернопільська обл., 48246","960","210","948","68","682","68","750","","0","682","68","750","30","720","200","223","98","2","7","0","190","29.10.12"
"610223","166","Тернопільська область","фельдшерсько-акушерський пункт, к.1
вул.Центральна, 436, с.Козина, Гусятинський р-н, Тернопільська обл., 48231","128","34","123","7","87","7","94","","0","87","7","94","7","87","26","26","3","0","0","0","32","28.10.12"
"610224","166","Тернопільська область","фельдшерсько-акушерський пункт, к.1
вул.Висока, 41, с.Кокошинці, Гусятинський р-н, Тернопільська обл., 48215","104","22","101","21","61","21","82","","0","61","21","82","2","80","45","16","10","0","0","2","7","29.10.12"
"610225","166","Тернопільська область","будинок культури, танцювальний зал
вул.Шевченка, 13, м.Копичинці, Гусятинський р-н, Тернопільська обл., 48260","1840","686","1817","18","1142","12","1154","","0","1142","12","1154","32","1122","511","273","171","1","27","11","128","29.10.12"
"610226","166","Тернопільська область","кінотеатр, фойє
вул.Чортківська, 5, м.Копичинці, Гусятинський р-н, Тернопільська обл., 48260","1832","739","1811","37","1059","34","1093","","0","1059","34","1093","19","1074","434","382","131","2","22","12","91","29.10.12"
"610227","166","Тернопільська область","школа №2, фойє
вул.Л.Українки, 7, м.Копичинці, Гусятинський р-н, Тернопільська обл., 48260","1632","638","1622","64","935","59","994","","0","935","59","994","22","972","392","370","108","6","24","6","66","29.10.12"
"610228","166","Тернопільська область","будинок культури, фойє
вул.Шевченка, 1Б, с.Котівка, Гусятинський р-н, Тернопільська обл., 48270","760","249","752","35","479","32","511","","0","479","32","511","9","502","261","114","45","1","18","5","58","29.10.12"
"610229","166","Тернопільська область","школа, фойє
вул.Зелений кут, 3, с.Коцюбинці, Гусятинський р-н, Тернопільська обл., 48271","1336","233","1325","111","992","111","1103","","0","992","111","1103","22","1081","627","283","59","6","20","3","83","29.10.12"
"610230","166","Тернопільська область","школа, фойє
вул.Центральна, 1, с.Красне, Гусятинський р-н, Тернопільська обл., 48231","464","114","458","30","323","27","350","","0","323","27","350","13","337","169","51","16","1","7","1","92","29.10.12"
"610231","166","Тернопільська область","будинок культури, фойє
вул.Центральна, 5, с.Крогулець, Гусятинський р-н, Тернопільська обл., 48256","672","202","655","31","439","31","470","","0","439","31","470","21","449","143","156","44","5","14","2","85","29.10.12"
"610232","166","Тернопільська область","сільський клуб, концертний зал
вул.Л.Українки, 105, с.Лежанівка, Гусятинський р-н, Тернопільська обл., 48210","216","73","208","27","116","27","143","","0","116","27","143","2","141","63","31","30","0","1","16","0","29.10.12"
"610233","166","Тернопільська область","будинок культури, фойє
вул.Замісця, 3, с.Личківці, Гусятинський р-н, Тернопільська обл., 48253","1608","405","1596","137","1066","137","1203","","0","1066","137","1203","25","1178","447","371","201","5","37","4","113","28.10.12"
"610234","166","Тернопільська область","сільський клуб, концертний зал
вул.Центральна, 114, с.Майдан, Гусятинський р-н, Тернопільська обл., 48266","192","67","186","16","112","13","125","","0","112","13","125","5","120","46","41","5","0","1","0","27","29.10.12"
"610235","166","Тернопільська область","сільський клуб, концертний зал
вул.Шевченка, 40, с.Малі Бірки, Гусятинський р-н, Тернопільська обл., 48234","296","71","295","33","192","33","225","","0","192","33","225","4","221","65","93","20","0","4","1","38","29.10.12"
"610236","166","Тернопільська область","сільська рада, зал засідань
вул.І.Левицького, 25, с.Мала Лука, Гусятинський р-н, Тернопільська обл., 48215","264","66","261","17","182","16","198","","0","182","16","198","3","195","42","76","7","2","4","2","62","29.10.12"
"610237","166","Тернопільська область","сільський клуб, концертний зал
вул.Центр, 31, с.Целіїв, Гусятинський р-н, Тернопільська обл., 48250","480","159","479","38","285","36","321","","0","285","36","321","14","307","84","84","43","4","7","2","83","29.10.12"
"610238","166","Тернопільська область","сільський клуб, концертний зал
вул.Польова, 3, с.Монастериха, Гусятинський р-н, Тернопільська обл., 48215","176","41","169","25","110","25","135","","0","110","25","135","8","127","48","20","19","1","1","1","37","29.10.12"
"610239","166","Тернопільська область","сільська рада, зал засідань
вул.Центральна, 1, с.Нижбірок, Гусятинський р-н, Тернопільська обл., 48255","960","338","946","50","576","46","622","","0","576","46","622","29","593","233","147","39","2","8","2","162","29.10.12"
"610240","166","Тернопільська область","фельдшерсько-акушерський пункт, к.1
вул.Л.Українки, 28, с.Новосілка, Гусятинський р-н, Тернопільська обл., 48234","184","52","175","20","112","20","132","","0","112","20","132","1","131","36","58","9","1","6","0","21","30.10.12"
"610241","166","Тернопільська область","сільський клуб, концертний зал
вул.Шкільна, 2, с.Оленівка, Гусятинський р-н, Тернопільська обл., 48210","272","65","267","31","178","29","207","","0","178","29","207","5","202","58","41","40","2","2","2","57","28.10.12"
"610242","166","Тернопільська область","будинок культури, фойє
вул.Лесі Українки, 28, с.Оришківці, Гусятинський р-н, Тернопільська обл., 48272","1160","428","1093","54","679","53","732","","0","679","53","732","10","722","365","185","74","1","9","5","83","29.10.12"
"610243","166","Тернопільська область","сільський клуб, концертний зал
вул.Нова, 21, с.Паївка, Гусятинський р-н, Тернопільська обл., 48230","352","83","347","29","240","29","269","","0","240","29","269","4","265","78","127","17","0","3","0","40","29.10.12"
"610244","166","Тернопільська область","будинок культури, фойє
вул.Незалежності, 2, с.Перемилів, Гусятинський р-н, Тернопільська обл., 48245","928","247","909","52","629","52","681","","0","629","52","681","20","661","221","183","110","3","65","5","74","29.10.12"
"610245","166","Тернопільська область","сільська рада, кабінет секретаря
вул.Нижння, 18, с.Пізнанка, Гусятинський р-н, Тернопільська обл., 48216","232","63","223","7","162","7","169","","0","162","7","169","3","166","73","49","10","0","8","0","26","29.10.12"
"610246","166","Тернопільська область","будинок культури, фойє
вул.Раків Кут, 11Б, с.Постолівка, Гусятинський р-н, Тернопільська обл., 48236","1040","243","1031","91","708","89","797","","0","708","89","797","32","765","317","117","76","6","128","4","117","29.10.12"
"610247","166","Тернопільська область","будинок культури, фойє
вул.Центральна, 250, с.Раштівці, Гусятинський р-н, Тернопільська обл., 48235","560","133","551","51","380","47","427","","0","380","47","427","12","415","174","95","66","5","13","1","61","29.10.12"
"610248","166","Тернопільська область","сільський клуб, концертний зал
вул.Незалежності, 32, с.Саджівка, Гусятинський р-н, Тернопільська обл., 48231","296","39","293","30","227","30","257","","0","227","30","257","11","246","96","43","46","0","20","0","41","29.10.12"
"610249","166","Тернопільська область","будинок культури, танцювальний зал
вул.Петра Козака, 18, с.Самолусківці, Гусятинський р-н, Тернопільська обл., 48251","784","154","770","40","591","39","630","","0","591","39","630","14","616","256","205","75","2","28","7","43","29.10.12"
"610250","166","Тернопільська область","будинок культури, фойє
вул.Центральна, 39, с.Сидорів, Гусятинський р-н, Тернопільська обл., 48208","872","219","861","67","593","60","653","","0","593","60","653","7","646","288","132","81","4","35","2","104","29.10.12"
"610251","166","Тернопільська область","будинок культури, концертний зал
вул.Центральна, 25А, с.Сорока, Гусятинський р-н, Тернопільська обл., 48238","608","142","599","37","429","37","466","","0","429","37","466","17","449","79","78","153","6","19","3","111","29.10.12"
"610252","166","Тернопільська область","сільський клуб, концертний зал
вул.Центральна, 362, с.Ставки, Гусятинський р-н, Тернопільська обл., 48231","64","22","56","5","38","4","42","","0","38","4","42","1","41","16","6","7","1","0","0","11","29.10.12"
"610253","166","Тернопільська область","будинок культури, зал урочистих подій
вул.Шевченка, 23, с.Старий Нижбірок, Гусятинський р-н, Тернопільська обл., 48252","776","174","764","48","554","48","602","","0","554","48","602","12","590","203","180","50","2","9","1","145","29.10.12"
"610254","166","Тернопільська область","будинок культури, фойє
вул.Центральна, 13, с.Суходіл, Гусятинський р-н, Тернопільська обл., 48207","512","120","502","40","353","39","392","","0","353","39","392","7","385","97","82","59","2","27","2","116","29.10.12"
"610255","166","Тернопільська область","сільський клуб, концертний зал
вул.Заньковецької, 4, с.Сухостав, Гусятинський р-н, Тернопільська обл., 48265","720","249","703","71","400","71","471","","0","400","71","471","18","453","215","100","76","3","7","0","52","29.10.12"
"610256","166","Тернопільська область","сільський клуб, концертний зал
вул.Центральна, 1Б, с.Теклівка, Гусятинський р-н, Тернопільська обл., 48270","160","27","158","10","123","10","133","","0","123","10","133","2","131","65","34","4","1","2","0","25","29.10.12"
"610257","166","Тернопільська область","сільська рада, зал засідань, 2-й поверх
вул.Боднарівка, 2, с.Товсте, Гусятинський р-н, Тернопільська обл., 48232","576","147","572","79","352","77","429","","0","352","77","429","10","419","155","148","50","0","12","1","53","29.10.12"
"610258","166","Тернопільська область","сільська рада, зал засідань, 2-й поверх
вул.Центральна, 10, с.Тудорів, Гусятинський р-н, Тернопільська обл., 48266","376","104","375","42","231","41","272","","0","231","41","272","9","263","74","97","18","1","3","2","68","29.10.12"
"610259","166","Тернопільська область","школа, актова зала
вул.Миру, 103, с.Увисла, Гусятинський р-н, Тернопільська обл., 48206","1032","230","1025","87","718","84","802","","0","718","84","802","15","787","428","58","252","4","15","0","30","29.10.12"
"610260","166","Тернопільська область","будинок культури, концертний зал
вул.Шевченка, 234Г, с.Хлопівка, Гусятинський р-н, Тернопільська обл., 48247","904","241","889","53","610","53","663","","0","610","53","663","22","641","214","148","183","3","9","3","81","29.10.12"
"610261","166","Тернопільська область","будинок культури, фойє
вул.Івасюка, 19, м.Хоростків, Гусятинський р-н, Тернопільська обл., 48240","1336","468","1317","37","831","37","868","","0","831","37","868","18","850","312","247","193","3","39","6","50","29.10.12"
"610262","166","Тернопільська область","школа №1, фойє
вул.Івасюка, 3, м.Хоростків, Гусятинський р-н, Тернопільська обл., 48240","1136","471","1132","21","645","20","665","","0","645","20","665","23","642","249","207","126","3","19","1","37","29.10.12"
"610263","166","Тернопільська область","школа №2, фойє
вул.Незалежності, 17, м.Хоростків, Гусятинський р-н, Тернопільська обл., 48240","1512","567","1497","22","924","21","945","","0","924","21","945","32","913","336","294","183","4","26","6","64","29.10.12"
"610264","166","Тернопільська область","Хоростківський спиртовий завод, фойє
вул.Незалежності, 21, м.Хоростків, Гусятинський р-н, Тернопільська обл., 48240","1496","595","1493","26","875","26","901","","0","875","26","901","35","866","280","275","181","2","43","5","80","29.10.12"
"610265","166","Тернопільська область","сільський клуб, концертний зал
вул.Гора, 1А, с.Целіїв, Гусятинський р-н, Тернопільська обл., 48250","592","177","578","47","370","45","415","","0","370","45","415","19","396","142","148","35","2","4","1","64","29.10.12"
"610266","166","Тернопільська область","будинок культури, фойє
вул.Центральна, 421А, с.Чабарівка, Гусятинський р-н, Тернопільська обл., 48258","896","240","881","53","605","51","656","","0","605","51","656","12","644","157","255","153","8","22","2","47","29.10.12"
"610267","166","Тернопільська область","сільський клуб, концертний зал
вул.Центральна, 2А, с.Чагарі, Гусятинський р-н, Тернопільська обл., 48271","200","37","197","10","153","10","163","","0","153","10","163","3","160","37","57","22","1","6","1","36","29.10.12"
"610268","166","Тернопільська область","сільський клуб, концертний зал
вул.Садова, 4, с.Шидлівці, Гусятинський р-н, Тернопільська обл., 48208","144","24","144","17","103","17","120","","0","103","17","120","5","115","38","31","1","1","1","0","43","29.10.12"
"610269","166","Тернопільська область","школа, фойє
вул.Грушевського, 42, с.Яблунів, Гусятинський р-н, Тернопільська обл., 48265","1536","453","1519","125","958","125","1083","","0","958","125","1083","25","1058","508","150","268","9","21","3","99","29.10.12"
"610270","166","Тернопільська область","Копичинецька виправна колонія №112, кімната психоемоційного розвантаження
вул.Шевченка, 96, м.Копичинці, Гусятинський р-н, Тернопільська обл., 48260","1000","17","984","0","983","0","983","","0","983","0","983","202","781","110","66","109","35","42","79","340","29.10.12"
"610665","166","Тернопільська область","районний палац культури, глядацький зал
вул.Шкільна, 2, м.Монастириська, Монастириський р-н, Тернопільська обл., 48300","1440","514","1412","16","910","16","926","","0","910","16","926","26","900","449","150","166","2","20","35","78","29.10.12"
"610666","166","Тернопільська область","бібліотека, фойє
вул.Шевченка, 18, м.Монастириська, Монастириський р-н, Тернопільська обл., 48300","1056","358","1038","15","683","15","698","","0","683","15","698","27","671","317","78","170","1","27","23","55","29.10.12"
"610667","166","Тернопільська область","школа, фойє
вул.Долішня, 4, м.Монастириська, Монастириський р-н, Тернопільська обл., 48300","1008","354","994","10","645","9","654","","0","645","9","654","18","636","403","61","125","4","7","6","30","29.10.12"
"610668","166","Тернопільська область","КП ""Монастириський комунсервіс"", зал засідань
вул.Підгородня, 5, м.Монастириська, Монастириський р-н, Тернопільська обл., 48300","1184","491","1158","15","678","15","693","","0","678","15","693","15","678","375","90","150","2","14","15","32","29.10.12"
"610669","166","Тернопільська область","сільська рада, фойє
вул.Шевченка, 12, с.Чехів, Монастириський р-н, Тернопільська обл., 48324","232","57","224","15","161","14","175","","0","161","14","175","3","172","57","46","34","2","19","2","12","29.10.12"
"610670","166","Тернопільська область","сільський клуб, глядацький зал
вул.Відродження, 30, с.Тростянці, Монастириський р-н, Тернопільська обл., 48333","256","82","256","23","151","23","174","","0","151","23","174","6","168","81","25","40","3","3","1","15","29.10.12"
"610671","166","Тернопільська область","дитячий садок, ігрова кімната
вул.Лесі Українки, 2А, с.Гончарівка, Монастириський р-н, Тернопільська обл., 48332","824","275","817","41","509","40","549","","0","509","40","549","24","525","306","67","91","3","13","7","38","29.10.12"
"610672","166","Тернопільська область","школа, спортивний зал
вул.Шевченка, 7А, с.Вербка, Монастириський р-н, Тернопільська обл., 48360","360","135","345","37","189","36","225","","0","189","36","225","6","219","96","49","53","1","0","7","13","29.10.12"
"610673","166","Тернопільська область","школа, актова зала
вул.Зелена, 25, с.Діброва, Монастириський р-н, Тернопільська обл., 48370","264","88","262","30","146","30","176","","0","146","30","176","3","173","70","25","45","5","5","3","20","29.10.12"
"610674","166","Тернопільська область","школа, спортивний зал
вул.Шевченка, 54, с.Доброводи, Монастириський р-н, Тернопільська обл., 48321","536","174","530","34","330","32","362","","0","330","32","362","18","344","148","37","106","5","5","6","37","29.10.12"
"610675","166","Тернопільська область","школа, спортивний зал
вул.Центральна, 39, с.Дубенка, Монастириський р-н, Тернопільська обл., 48350","496","154","490","48","298","44","342","","0","298","44","342","18","324","157","108","36","2","2","4","15","28.10.12"
"610676","166","Тернопільська область","школа, спортивний зал
вул.Центральна, 38, с.Завадівка, Монастириський р-н, Тернопільська обл., 48313","160","45","156","5","110","5","115","","0","110","5","115","6","109","39","34","20","0","1","0","15","29.10.12"
"610677","166","Тернопільська область","школа-сад, ігрова кімната
вул.Центральна, 10, с.Маркова, Монастириський р-н, Тернопільська обл., 48382","336","100","326","30","206","30","236","","0","206","30","236","12","224","120","45","37","0","2","1","19","29.10.12"
"610678","166","Тернопільська область","школа, актова зала
вул.Івана Франка, 1, с.Коржова, Монастириський р-н, Тернопільська обл., 48313","240","73","235","16","152","15","167","","0","152","15","167","5","162","55","16","74","0","0","2","15","29.10.12"
"610679","166","Тернопільська область","сільський клуб, глядацький зал
вул.Шевченка, 49, с.Лазарівка, Монастириський р-н, Тернопільська обл., 48342","336","107","332","18","213","16","229","","0","213","16","229","7","222","135","46","21","0","5","0","15","29.10.12"
"610680","166","Тернопільська область","фельдшерсько-акушерський пункт, фойє
вул.Кути, 1, с.Низьколизи, Монастириський р-н, Тернопільська обл., 48340","112","26","104","19","69","17","86","","0","69","17","86","0","86","57","9","5","0","0","0","15","28.10.12"
"610681","166","Тернопільська область","сільська рада, зал засідань
вул.Центральна, 9, с.Лядське, Монастириський р-н, Тернопільська обл., 48343","312","65","301","55","192","55","247","","0","192","55","247","7","240","159","65","7","0","0","4","5","29.10.12"
"610682","166","Тернопільська область","сільський клуб, глядацький зал
вул.Гора, 3, с.Бобрівники, Монастириський р-н, Тернопільська обл., 48343","208","55","202","14","139","14","153","","0","139","14","153","8","145","58","50","6","4","1","0","26","29.10.12"
"610683","166","Тернопільська область","сільський клуб, глядацький зал
вул.Добромишля, 38, с.Бобрівники, Монастириський р-н, Тернопільська обл., 48343","80","18","80","4","58","4","62","","0","58","4","62","1","61","35","7","5","0","1","0","13","29.10.12"
"610684","166","Тернопільська область","школа, спортивний зал
вул.Центральна, 180, с.Ковалівка, Монастириський р-н, Тернопільська обл., 48322","896","246","886","50","600","50","650","","0","600","50","650","53","597","282","84","170","5","6","2","48","29.10.12"
"610685","166","Тернопільська область","сільський клуб, глядацький зал
вул.Шевченка, 29, с.Олеша, Монастириський р-н, Тернопільська обл., 48323","280","67","277","14","199","14","213","","0","199","14","213","8","205","57","41","65","5","8","2","27","29.10.12"
"610686","166","Тернопільська область","сільський клуб, глядацький зал
вул.Підлісна, 1А, с.Савелівка, Монастириський р-н, Тернопільська обл., 48322","192","50","188","10","133","9","142","","0","133","9","142","4","138","43","32","50","1","2","0","10","28.10.12"
"610687","166","Тернопільська область","будинок культури, глядацький зал
вул.Незалежності, 2, с.Горигляди, Монастириський р-н, Тернопільська обл., 48372","896","468","884","34","404","24","428","","0","404","24","428","25","403","156","57","144","1","4","11","30","29.10.12"
"610688","166","Тернопільська область","школа, актова зала
вул.Марка Каганця, 28, смт Коропець, Монастириський р-н, Тернопільська обл., 48370","1432","618","1414","66","752","62","814","","0","752","62","814","18","796","477","95","134","4","34","8","44","28.10.12"
"610689","166","Тернопільська область","школа, к.1
вул.Шевченка, 180, смт Коропець, Монастириський р-н, Тернопільська обл., 48370","760","275","747","55","432","53","485","","0","432","53","485","15","470","247","123","59","5","8","6","22","29.10.12"
"610690","166","Тернопільська область","будинок культури, глядацький зал
вул.Ів-Франка, 110, смт Коропець, Монастириський р-н, Тернопільська обл., 48370","456","163","450","31","262","31","293","","0","262","31","293","11","282","154","55","40","0","1","8","24","28.10.12"
"610691","166","Тернопільська область","школа, фойє
вул.Вадівська, 46А, с.Світле, Монастириський р-н, Тернопільська обл., 48370","224","119","218","18","92","13","105","","0","92","13","105","2","103","64","20","9","1","3","2","4","29.10.12"
"610692","166","Тернопільська область","сільський клуб, глядацький зал
вул.Черешнева, 49Б, с.Стигла, Монастириський р-н, Тернопільська обл., 48370","224","98","217","13","114","12","126","","0","114","12","126","7","119","66","13","26","1","4","4","5","29.10.12"
"610693","166","Тернопільська область","школа, спортивний зал
вул.Центральна, 16, с.Комарівка, Монастириський р-н, Тернопільська обл., 48352","272","81","267","28","164","27","191","","0","164","27","191","8","183","77","25","37","5","9","6","24","29.10.12"
"610694","166","Тернопільська область","будинок культури, глядацький зал
вул.Шевченка, 105А, с.Красіїв, Монастириський р-н, Тернопільська обл., 48334","568","165","558","62","341","62","403","","0","341","62","403","21","382","264","35","35","2","18","2","26","29.10.12"
"610695","166","Тернопільська область","будинок культури, глядацький зал
вул.Шевченка, 28А, с.Горішня Слобідка, Монастириський р-н, Тернопільська обл., 48315","608","167","602","30","411","30","441","","0","411","30","441","15","426","232","52","114","2","5","4","17","29.10.12"
"610696","166","Тернопільська область","сільський клуб, глядацький зал
вул.Миру, 31А, с.Нова-Гута, Монастириський р-н, Тернопільська обл., 48300","184","61","164","14","109","14","123","","0","109","14","123","2","121","72","14","25","1","1","0","8","29.10.12"
"610697","166","Тернопільська область","школа, спортивний зал
вул.Грушевського, 36, с.Вістря, Монастириський р-н, Тернопільська обл., 48371","768","267","760","31","471","30","501","","0","471","30","501","14","487","207","49","162","3","9","3","54","28.10.12"
"610698","166","Тернопільська область","сільська рада, зал засідань
вул.Шевченка, 17, с.Задарів, Монастириський р-н, Тернопільська обл., 48340","816","273","800","49","499","44","543","","0","499","44","543","19","524","377","50","54","1","8","4","30","29.10.12"
"610699","166","Тернопільська область","школа, фойє
вул.Шевченка, 11, с.Сеньків, Монастириський р-н, Тернопільська обл., 48340","168","56","166","5","107","5","112","","0","107","5","112","7","105","49","18","15","1","1","3","18","29.10.12"
"610700","166","Тернопільська область","сільська рада, фойє
вул.Шевченка, 101, с.Григорів, Монастириський р-н, Тернопільська обл., 48324","488","140","481","29","320","28","348","","0","320","28","348","8","340","122","121","70","2","2","1","22","29.10.12"
"610701","166","Тернопільська область","школа, актова зала
вул.Нагірянка, 44, с.Велеснів, Монастириський р-н, Тернопільська обл., 48351","504","189","500","25","292","23","315","","0","292","23","315","10","305","164","62","49","0","3","4","23","29.10.12"
"610702","166","Тернопільська область","школа, актова зала
вул.Л.Українки, 36, с.Залісся, Монастириський р-н, Тернопільська обл., 48312","200","64","195","15","122","14","136","","0","122","14","136","10","126","57","29","29","1","1","3","6","29.10.12"
"610703","166","Тернопільська область","сільський клуб, глядацький зал
вул.Шевченка, 89, с.Криниця, Монастириський р-н, Тернопільська обл., 48381","488","162","485","26","304","22","326","","0","304","22","326","8","318","192","42","68","0","1","3","12","29.10.12"
"610704","166","Тернопільська область","школа, спортивний зал
вул.Центральна, 8А, с.Заставці, Монастириський р-н, Тернопільська обл., 48314","264","76","263","27","164","24","188","","0","164","24","188","4","184","86","59","27","1","3","0","8","29.10.12"
"610705","166","Тернопільська область","будинок культури, глядацький зал
вул.Шевченка, 15, с.Гранітне, Монастириський р-н, Тернопільська обл., 48331","264","86","264","12","166","12","178","","0","166","12","178","3","175","89","29","29","1","1","4","22","29.10.12"
"610706","166","Тернопільська область","школа, спортивний зал
вул.Чорновола, 28А, с.Високе, Монастириський р-н, Тернопільська обл., 48312","912","232","904","46","635","45","680","","0","635","45","680","5","675","303","53","262","4","25","6","22","28.10.12"
"610707","166","Тернопільська область","сільська рада, зал засідань
вул.Шевченка, 41, с.Садове, Монастириський р-н, Тернопільська обл., 48361","176","69","177","18","94","13","107","","0","94","13","107","1","106","64","22","11","0","0","2","7","29.10.12"
"610708","166","Тернопільська область","школа, спортивний зал
вул.Підлісна, 19, с.Яргорів, Монастириський р-н, Тернопільська обл., 48330","456","185","453","16","256","15","271","","0","256","15","271","18","253","109","44","74","3","0","1","22","28.10.12"
"610709","166","Тернопільська область","школа, спортивний зал
вул.Шевченка, 31А, с.Устя-Зелене, Монастириський р-н, Тернопільська обл., 48341","408","107","408","56","250","51","301","","0","250","51","301","8","293","156","83","29","2","2","5","16","28.10.12"
"610710","166","Тернопільська область","сільський будинок культури, глядацький зал
вул.Шевченка, 13, с.Лука, Монастириський р-н, Тернопільська обл., 48341","224","46","215","20","159","19","178","","0","159","19","178","7","171","98","10","41","1","1","0","20","29.10.12"
"610711","166","Тернопільська область","сільський будинок культури, глядацький зал
вул.Шевченка, 27А, с.Межигір’я, Монастириський р-н, Тернопільська обл., 48341","200","29","198","28","145","26","171","","0","145","26","171","4","167","99","42","14","1","0","3","8","29.10.12"
"610712","166","Тернопільська область","школа, спортивний зал
вул.Галицька, 36А, с.Підлісне, Монастириський р-н, Тернопільська обл., 48310","280","125","276","21","135","20","155","","0","135","20","155","7","148","39","50","11","1","3","1","43","30.10.12"
"610713","166","Тернопільська область","дитячий садок, ігрова кімната
вул.Шевченка, 58, с.Бертники, Монастириський р-н, Тернопільська обл., 48324","328","109","317","13","206","13","219","","0","206","13","219","7","212","134","29","23","1","12","2","11","29.10.12"
"610714","166","Тернопільська область","сільська рада, зал засідань
вул.Шкільна, 2А, с.Швейків, Монастириський р-н, Тернопільська обл., 48314","536","148","529","50","340","48","388","","0","340","48","388","11","377","236","74","40","1","5","3","18","29.10.12"
"610715","166","Тернопільська область","сільська рада, зал засідань
вул.Першотравнева, 10, с.Горожанка, Монастириський р-н, Тернопільська обл., 48311","680","224","674","59","403","53","456","","0","403","53","456","21","435","185","137","77","1","7","4","24","29.10.12"
"610716","166","Тернопільська область","терапевтичне відділення РТМО, фойє
вул.Краснікова, 7, м.Монастириська, Тернопільська обл., 48300","40","9","38","0","31","0","31","","0","31","0","31","4","27","7","3","4","0","1","0","12","29.10.12"
"610814","166","Тернопільська область","сільський клуб, глядацький зал
вул.М.Грушевського, 1, с.Багатківці, Теребовлянський р-н, Тернопільська обл., 48110","456","113","440","63","280","63","343","","0","280","63","343","5","338","51","117","59","11","10","1","89","29.10.12"
"610815","166","Тернопільська область","сільський клуб, глядацький зал
вул.Т.Г.Шевченка, 21, с.Бенева, Теребовлянський р-н, Тернопільська обл., 48111","248","59","246","23","168","21","189","","0","168","21","189","4","185","62","44","27","2","0","1","49","29.10.12"
"610816","166","Тернопільська область","будинок культури, глядацький зал
вул.Міцкевича, 10, с.Буданів, Теребовлянський р-н, Тернопільська обл., 48154","1208","358","1185","115","736","114","850","","0","736","114","850","18","832","385","246","129","4","6","4","58","29.10.12"
"610817","166","Тернопільська область","сільський клуб, глядацький зал
вул.Ровиська, 53А, с.Папірня, Теребовлянський р-н, Тернопільська обл., 48150","184","52","184","20","112","20","132","","0","112","20","132","6","126","45","28","35","1","0","1","16","29.10.12"
"610818","166","Тернопільська область","будинок культури, глядацький зал
вул.Шкільна, 23, с.Бурканів, Теребовлянський р-н, Тернопільська обл., 48116","608","139","598","42","427","42","469","","0","427","42","469","13","456","143","38","164","9","3","3","96","29.10.12"
"610819","166","Тернопільська область","будинок культури, фойє
вул.Є.Олесницького, 28, с.Великий Говилів, Теребовлянський р-н, Тернопільська обл., 48162","856","221","847","27","608","27","635","","0","608","27","635","11","624","302","179","77","3","15","1","47","30.10.12"
"610820","166","Тернопільська область","сільський клуб, глядацький зал
вул.С.Бандери, 1, с.Малий Говилів, Теребовлянський р-н, Тернопільська обл., 48162","328","85","320","18","225","18","243","","0","225","18","243","7","236","109","89","17","1","4","1","15","29.10.12"
"610821","166","Тернопільська область","будинок культури, глядацький зал
вул.Кульчики, 17, с.Вербівці, Теребовлянський р-н, Тернопільська обл., 48155","608","147","593","66","399","62","461","","0","399","62","461","10","451","109","198","44","3","2","2","93","29.10.12"
"610822","166","Тернопільська область","сільська рада, зал засідань
вул.Й.Сліпого, 77, с.Вишнівчик, Теребовлянський р-н, Тернопільська обл., 48142","472","129","465","40","304","39","343","","0","304","39","343","15","328","84","104","99","4","2","4","31","29.10.12"
"610823","166","Тернопільська область","будинок культури, глядацький зал
вул.Шевченка, 17, с.Гайворонка, Теребовлянський р-н, Тернопільська обл., 48140","344","73","335","42","229","42","271","","0","229","42","271","9","262","99","66","65","6","0","0","26","29.10.12"
"610824","166","Тернопільська область","будинок культури, фойє
вул.Центральна, 39, с.Гвардійське, Теребовлянський р-н, Тернопільська обл., 48141","304","73","299","23","208","23","231","","0","208","23","231","2","229","41","81","78","2","1","0","26","29.10.12"
"610825","166","Тернопільська область","сільська рада, зал засідань
вул.Кінець, 72, с.Глещава, Теребовлянський р-н, Тернопільська обл., 48136","568","148","563","46","376","44","420","","0","376","44","420","13","407","164","143","67","0","4","2","27","29.10.12"
"610826","166","Тернопільська область","будинок культури, глядацький зал
вул.Сонячна, 1А, с.Дарахів, Теребовлянський р-н, Тернопільська обл., 48146","1576","529","1554","121","934","113","1047","","0","934","113","1047","35","1012","381","201","346","10","9","1","64","29.10.12"
"610827","166","Тернопільська область","сільський клуб, глядацький зал
вул.С.Бандери, 91, с.Тютьків, Теребовлянський р-н, Тернопільська обл., 48147","376","120","379","40","216","40","256","","0","216","40","256","5","251","62","38","113","3","0","3","32","29.10.12"
"610828","166","Тернопільська область","сільський клуб, глядацький зал
вул.Слобідська, 28, с.Кам’янка, Теребовлянський р-н, Тернопільська обл., 48146","136","31","136","7","99","6","105","","0","99","6","105","5","100","22","21","32","0","0","1","24","30.10.12"
"610829","166","Тернопільська область","сільська рада, зал засідань
вул.М.Грушевського, 37, с.Дворіччя, Теребовлянський р-н, Тернопільська обл., 48123","440","99","431","35","306","35","341","","0","306","35","341","17","324","59","197","39","2","1","4","22","28.10.12"
"610830","166","Тернопільська область","будинок культури, глядацький зал
вул.Осіння, 3А, с.Довге, Теребовлянський р-н, Тернопільська обл., 48160","520","117","517","24","381","22","403","","0","381","22","403","14","389","99","105","147","1","4","5","28","29.10.12"
"610831","166","Тернопільська область","сільський клуб, великий зал
вул.Купчинського, 114А, с.Деренівка, Теребовлянський р-н, Тернопільська обл., 48173","384","88","371","42","254","42","296","","0","254","42","296","7","289","127","74","61","1","5","3","18","29.10.12"
"610832","166","Тернопільська область","сільський клуб, глядацький зал
вул.Янівська, 11А, с.Долина, Теребовлянський р-н, Тернопільська обл., 48163","672","184","667","45","443","45","488","","0","443","45","488","16","472","111","121","194","3","10","1","32","29.10.12"
"610833","166","Тернопільська область","сільський клуб, глядацький зал
вул.Дисевича, 21А, с.Слобідка, Теребовлянський р-н, Тернопільська обл., 48163","320","60","315","30","231","29","260","","0","231","29","260","2","258","111","36","86","1","3","1","20","29.10.12"
"610834","166","Тернопільська область","будинок культури, глядацький зал
вул.Й.Сліпого, 99, с.Заздрість, Теребовлянський р-н, Тернопільська обл., 48125","616","225","616","36","355","36","391","","0","355","36","391","12","379","218","81","42","2","3","7","26","29.10.12"
"610835","166","Тернопільська область","сільський клуб, глядацький зал
вул.Кардинала Шептицького, 33, с.Зарваниця, Теребовлянський р-н, Тернопільська обл., 48143","224","50","221","20","155","19","174","","0","155","19","174","6","168","42","75","42","0","1","0","8","28.10.12"
"610836","166","Тернопільська область","сільський клуб, глядацький зал
вул.Ореста Гальчука, 4, с.Сапова, Теребовлянський р-н, Тернопільська обл., 48143","112","26","104","15","72","14","86","","0","72","14","86","1","85","13","56","13","0","0","0","3","28.10.12"
"610837","166","Тернопільська область","сільська рада, зал засідань
вул.Містечко, 33, с.Золотники, Теребовлянський р-н, Тернопільська обл., 48115","1336","458","1326","107","780","98","878","","0","780","98","878","36","842","277","168","329","20","6","3","39","29.10.12"
"610838","166","Тернопільська область","будинок культури, глядацький зал
вул.Ринок, 16, с.Іванівка, Теребовлянський р-н, Тернопільська обл., 48137","1184","224","1167","62","899","61","960","","0","899","61","960","32","928","503","226","75","0","10","4","110","29.10.12"
"610839","166","Тернопільська область","сільський клуб, глядацький зал
вул.Набережна, 2, с.Лозівка, Теребовлянський р-н, Тернопільська обл., 48137","96","35","92","12","49","12","61","","0","49","12","61","3","58","19","14","8","1","2","0","14","29.10.12"
"610840","166","Тернопільська область","сільська рада, зал засідань
вул.Т.Г.Шевченка, 66, с.Ілавче, Теребовлянський р-н, Тернопільська обл., 48134","1120","340","1102","116","674","106","780","","0","674","106","780","23","757","212","283","146","8","11","5","92","29.10.12"
"610841","166","Тернопільська область","будинок культури, глядацький зал
вул.Центральна, 168, с.Кобиловолоки, Теребовлянський р-н, Тернопільська обл., 48164","1144","297","1139","118","729","118","847","","0","729","118","847","27","820","234","259","248","3","11","3","62","29.10.12"
"610842","166","Тернопільська область","сільський клуб, глядацький зал
вул.Центральна, 201, с.Млиниська, Теребовлянський р-н, Тернопільська обл., 48164","328","39","327","24","266","23","289","","0","266","23","289","7","282","144","50","63","2","3","1","19","29.10.12"
"610843","166","Тернопільська область","школа, кабінет української мови та літератури
вул.Шевченка, 30, с.Котузів, Теребовлянський р-н, Тернопільська обл., 48141","304","91","300","32","184","29","213","","0","184","29","213","10","203","35","96","53","2","1","0","16","29.10.12"
"610844","166","Тернопільська область","сільський клуб, глядацький зал
вул.Лошнівська, 1А, с.Кровинка, Теребовлянський р-н, Тернопільська обл., 48135","1072","327","1058","43","702","43","745","","0","702","43","745","19","726","166","194","239","1","18","3","105","29.10.12"
"610845","166","Тернопільська область","сільська рада, зал засідань
вул.Т.Шевченка, 4, с.Ладичин, Теребовлянський р-н, Тернопільська обл., 48124","904","288","896","73","546","70","616","","0","546","70","616","12","604","212","111","246","0","11","0","24","29.10.12"
"610846","166","Тернопільська область","будинок культури, глядацький зал
вул.Центральна, 104, с.Ласківці, Теребовлянський р-н, Тернопільська обл., 48153","1368","420","1355","123","829","119","948","","0","829","119","948","30","918","437","333","51","3","4","4","86","29.10.12"
"610847","166","Тернопільська область","школа, фойє
вул.Центральна, 44, с.Лошнів, Теребовлянський р-н, Тернопільська обл., 48133","1040","94","1029","91","855","91","946","","0","855","91","946","7","939","357","228","265","0","3","6","80","29.10.12"
"610848","166","Тернопільська область","будинок культури, великий зал
вул.Шкільна, 34, с.Маловоди, Теребовлянський р-н, Тернопільська обл., 48140","184","39","181","31","117","28","145","","0","117","28","145","8","137","12","66","29","1","0","1","28","28.10.12"
"610849","166","Тернопільська область","сільська рада, зал засідань
вул.Центральна, 14, с.Нова Могильниця, Теребовлянський р-н, Тернопільська обл., 48179","464","138","455","74","252","74","326","","0","252","74","326","10","316","83","105","110","3","2","2","11","29.10.12"
"610850","166","Тернопільська область","будинок культури, глядацький зал
вул.Центральна, 15, с.Стара Могильниця, Теребовлянський р-н, Тернопільська обл., 48179","376","121","370","61","196","59","255","","0","196","59","255","10","245","117","37","70","0","4","0","17","29.10.12"
"610851","166","Тернопільська область","школа, фойє
вул.Шкільна, 1, с.Мшанець, Теребовлянський р-н, Тернопільська обл., 48161","832","241","820","38","553","38","591","","0","553","38","591","9","582","239","84","74","3","7","2","173","29.10.12"
"610852","166","Тернопільська область","будинок культури, глядацький зал
вул.Зелена, 2, с.Надрічне, Теребовлянський р-н, Тернопільська обл., 48113","384","92","380","46","246","46","292","","0","246","46","292","10","282","82","89","44","17","0","0","50","28.10.12"
"610853","166","Тернопільська область","школа, кабінет групи продовженого дня
вул.Центральна, 13, с.Острівець, Теребовлянський р-н, Тернопільська обл., 48107","328","71","325","21","236","21","257","","0","236","21","257","5","252","86","79","74","2","2","4","5","29.10.12"
"610854","166","Тернопільська область","школа, кабінет зарубіжної літератури
вул.Центральна, 13, с.Острівець, Теребовлянський р-н, Тернопільська обл., 48107","368","100","367","40","228","40","268","","0","228","40","268","7","261","124","91","31","0","6","1","8","29.10.12"
"610855","166","Тернопільська область","школа, учительська
вул.Підстінка, 65, с.Гумниська, Теребовлянський р-н, Тернопільська обл., 48172","512","180","503","27","305","27","332","","0","305","27","332","5","327","105","131","49","1","3","2","36","29.10.12"
"610856","166","Тернопільська область","будинок культури, глядацький зал
вул.Шляхетна, 21, с.Підгайчики, Теребовлянський р-н, Тернопільська обл., 48150","728","170","722","52","506","52","558","","0","505","52","557","20","537","174","96","88","4","4","3","168","29.10.12"
"610857","166","Тернопільська область","сільський клуб, глядацький зал
вул.Семенівська, 74, с.Семенів, Теребовлянський р-н, Тернопільська обл., 48108","432","140","426","4","288","4","292","","0","288","4","292","1","291","113","92","56","1","1","1","27","29.10.12"
"610858","166","Тернопільська область","сільський клуб, глядацький зал
вул.Зеленецька, 45А, с.Зеленче, Теребовлянський р-н, Тернопільська обл., 48108","392","91","382","23","278","23","301","","0","278","23","301","8","293","94","86","59","4","14","2","34","29.10.12"
"610859","166","Тернопільська область","сільський клуб, кабінет завідувача
вул.Шевченка, 23, с.Малів, Теребовлянський р-н, Тернопільська обл., 48108","240","80","238","1","159","1","160","","0","159","1","160","1","159","71","33","33","0","7","0","15","29.10.12"
"610860","166","Тернопільська область","будинок культури, фойє
вул.Князя Василька, 17, с.Плебанівка, Теребовлянський р-н, Тернопільська обл., 48117","904","262","893","63","582","60","642","","0","582","60","642","9","633","163","224","189","8","22","4","23","29.10.12"
"610861","166","Тернопільська область","сільський клуб, глядацький зал
вул.Т.Г.Шевченка, 12А, с.Залав’є, Теребовлянський р-н, Тернопільська обл., 48174","392","95","386","35","264","33","297","","0","264","33","297","9","288","110","69","76","0","7","0","26","29.10.12"
"610862","166","Тернопільська область","сільський клуб, глядацький зал
вул.Братів Бойчуків, 58, с.Романівка, Теребовлянський р-н, Тернопільська обл., 48151","496","149","487","68","288","59","347","","0","288","59","347","7","340","77","178","52","1","5","1","26","29.10.12"
"610863","166","Тернопільська область","сільський клуб, глядацький зал
вул.Шевченка, 10А, с.Різдвяни, Теребовлянський р-н, Тернопільська обл., 48107","432","113","426","34","285","34","319","","0","285","34","319","6","313","72","73","143","0","7","1","17","29.10.12"
"610864","166","Тернопільська область","сільський клуб, глядацький зал
вул.Стависко, 1А, с.Зубів, Теребовлянський р-н, Тернопільська обл., 48108","312","87","299","21","204","21","225","","0","204","21","225","10","215","68","65","63","2","5","2","10","29.10.12"
"610865","166","Тернопільська область","сільський клуб, глядацький зал
вул.Набережна, 45, с.Семиківці, Теребовлянський р-н, Тернопільська обл., 48111","184","20","182","11","153","11","164","","0","153","11","164","2","162","84","49","10","3","0","0","16","29.10.12"
"610866","166","Тернопільська область","фельдшерсько-акушерський пункт, кабінет завідувача
вул.Молодіжна, 25, с.Підруда, Теребовлянський р-н, Тернопільська обл., 48111","64","16","60","4","45","3","48","","0","45","3","48","1","47","7","11","20","0","0","0","9","28.10.12"
"610867","166","Тернопільська область","сільський клуб, глядацький зал
вул.Шевченка, 25, с.Соколів, Теребовлянський р-н, Тернопільська обл., 48124","632","189","622","63","380","63","443","","0","380","63","443","18","425","106","144","81","63","3","3","25","29.10.12"
"610868","166","Тернопільська область","будинок культури, глядацький зал
вул.Нова, 41, с.Сороцьке, Теребовлянський р-н, Тернопільська обл., 48132","712","238","694","94","383","91","474","","0","383","91","474","10","464","158","212","49","6","3","2","34","30.10.12"
"610869","166","Тернопільська область","будинок культури, глядацький зал
вул.Шкільна, 3, с.Соснів, Теребовлянський р-н, Тернопільська обл., 48112","448","117","441","54","277","54","331","","0","277","54","331","15","316","98","138","26","12","4","7","31","29.10.12"
"610870","166","Тернопільська область","сільський клуб, глядацький зал
вул.Клубна, 5, с.Раковець, Теребовлянський р-н, Тернопільська обл., 48112","200","47","194","13","140","13","153","","0","140","13","153","4","149","45","50","17","1","0","4","32","29.10.12"
"610871","166","Тернопільська область","будинок культури, глядацький зал
вул.Центральна, 38А, с.Сущин, Теребовлянський р-н, Тернопільська обл., 48131","352","77","348","22","257","18","275","","0","257","18","275","3","272","40","85","120","1","2","4","20","29.10.12"
"610872","166","Тернопільська область","школа, каб.3
вул.Центральна, 55А, с.Остальці, Теребовлянський р-н, Тернопільська обл., 48131","280","82","271","26","172","26","198","","0","172","26","198","8","190","41","50","64","0","1","1","33","29.10.12"
"610873","166","Тернопільська область","сільська рада, зал засідань
вул.Миру, 3, с.Струсів, Теребовлянський р-н, Тернопільська обл., 48127","1152","353","1151","49","751","48","799","","0","751","48","799","26","773","243","244","204","6","36","2","38","29.10.12"
"610874","166","Тернопільська область","школа, фойє
вул.Братів Шкамбар, 42, с.Варваринці, Теребовлянський р-н, Тернопільська обл., 48126","1080","348","1068","42","692","40","732","","0","692","40","732","28","704","253","122","287","2","8","8","24","29.10.12"
"610875","166","Тернопільська область","школа-сад, каб.1
вул.Дружби, 42, с.Налужжя, Теребовлянський р-н, Тернопільська обл., 48176","376","105","364","12","260","11","271","","0","260","11","271","13","258","65","108","51","1","1","1","31","29.10.12"
"610876","166","Тернопільська область","бібліотека, каб.1
вул.Центральна, 40, с.Бернадівка, Теребовлянський р-н, Тернопільська обл., 48127","200","68","198","16","116","16","132","","0","116","16","132","2","130","18","21","67","1","7","2","14","29.10.12"
"610877","166","Тернопільська область","будинок культури, глядацький зал
вул.Сонячна, 20, с.Хмелівка, Теребовлянський р-н, Тернопільська обл., 48144","720","274","715","55","397","49","446","","0","397","49","446","16","430","164","136","77","4","3","3","43","29.10.12"
"610878","166","Тернопільська область","фельдшерсько-акушерський пункт, кабінет завідувача
вул.Центральна, 50, с.Нова Брикуля, Теребовлянський р-н, Тернопільська обл., 48145","208","60","205","32","118","30","148","","0","118","30","148","3","145","42","67","12","1","1","0","22","29.10.12"
"610879","166","Тернопільська область","будинок культури, глядацький зал
вул.Лесі Українки, 6А, смт Дружба, Теребовлянський р-н, Тернопільська обл., 48130","1448","553","1439","26","874","21","895","","0","874","21","895","17","878","373","286","159","8","16","3","33","29.10.12"
"610880","166","Тернопільська область","будинок культури, великий зал
вул.22 Січня, 8, смт Микулинці, Теребовлянський р-н, Тернопільська обл., 48120","1736","663","1725","63","1012","61","1073","","0","1012","61","1073","33","1040","400","341","173","8","21","16","81","29.10.12"
"610881","166","Тернопільська область","ВАТ ""Булат"", їдальня
вул.Тернопільська, 35, смт Микулинці, Теребовлянський р-н, Тернопільська обл., 48120","1000","363","997","17","623","14","637","","0","623","14","637","23","614","281","159","116","4","10","9","35","29.10.12"
"610882","166","Тернопільська область","школа-сад, каб.1
вул.Стебніцького, 50, с.Воля, Теребовлянський р-н, Тернопільська обл., 48171","600","214","587","31","355","31","386","","0","355","31","386","29","357","88","163","61","2","10","8","25","29.10.12"
"610883","166","Тернопільська область","сільський клуб, глядацький зал
вул.Коновальця, 1, с.Конопківка, Теребовлянський р-н, Тернопільська обл., 48122","520","141","517","30","353","26","379","","0","353","26","379","15","364","119","111","70","4","3","3","54","29.10.12"
"610884","166","Тернопільська область","сільський клуб, глядацький зал
вул.Зелена, 25А, с.Кривки, Теребовлянський р-н, Тернопільська обл., 48120","176","54","171","12","110","12","122","","0","110","12","122","7","115","44","37","11","1","1","0","21","29.10.12"
"610885","166","Тернопільська область","сільський клуб, глядацький зал
вул.Шевченка, 12А, с.Боричівка, Теребовлянський р-н, Тернопільська обл., 48106","456","139","457","54","263","54","317","","0","263","54","317","8","309","100","105","62","2","4","2","34","29.10.12"
"610886","166","Тернопільська область","спортивна школа, спортивний зал
вул.Князя Василька, 106, м.Теребовля, Теребовлянський р-н, Тернопільська обл., 48100","1560","602","1540","32","933","25","958","","0","933","25","958","24","934","329","258","267","4","36","5","35","29.10.12"
"610887","166","Тернопільська область","районний будинок культури, фойє
вул.Шевченка, 3, м.Теребовля, Теребовлянський р-н, Тернопільська обл., 48100","1008","447","994","19","546","15","561","","0","546","15","561","18","543","184","120","181","5","8","5","40","29.10.12"
"610888","166","Тернопільська область","школа №2, фойє
вул.Січових Стрільців, 28, м.Теребовля, Теребовлянський р-н, Тернопільська обл., 48100","1440","578","1395","24","847","15","862","","0","847","15","862","33","829","240","219","271","5","22","0","72","29.10.12"
"610889","166","Тернопільська область","школа №1, актова зала
вул.Січових Стрільців, 51А, м.Теребовля, Теребовлянський р-н, Тернопільська обл., 48100","2320","924","2294","30","1370","26","1396","","0","1370","26","1396","43","1353","469","280","460","10","26","16","92","29.10.12"
"610890","166","Тернопільська область","гімназія, актова зала
вул.Застіноцька, 41, м.Теребовля, Теребовлянський р-н, Тернопільська обл., 48100","1032","438","1030","23","573","21","594","","0","573","21","594","15","579","182","136","214","5","1","4","37","29.10.12"
"610891","166","Тернопільська область","школа №3, актова зала
вул.Шевченка, 188, м.Теребовля, Теребовлянський р-н, Тернопільська обл., 48100","2248","952","2233","218","1129","167","1296","","0","1129","167","1296","31","1265","441","363","333","9","25","6","88","29.10.12"
"610892","166","Тернопільська область","школа-інтернат для дітей з фізичними вадами, фойє
вул.Залізнична, 8, м.Теребовля, Теребовлянський р-н, Тернопільська обл., 48100","1160","436","1120","39","685","39","724","","0","685","39","724","6","718","217","203","215","2","35","7","39","29.10.12"
