"№ ВД","OBO","Назва регіону України","Місцезнаходження та адреса приміщення для голосування","1) К-сть одержаних бюлетенів","2) К-сть невикористаних бюлетенів","3) К-сть виборців, внесених до списку виборців","4) К-сть виборців, внесених до витягу зі списку виборців","5) К-сть виборців, які отримали бюлетені у приміщенні","6) К-сть виборців, які отримали за місцем перебування","7) Сумарна к-сть виборців, які отримали бюлетені","8) К-сть бюлетенів, що виявилися у кожній скринці","9) К-сть бюлетенів, що не підлягають врахуванню","10) К-сть виборців, які взяли участь у голос. у приміщенні для гол.","11) К-сть виборців, які взяли участь у голос. за місцем перебування","12) К-сть виборців, які взяли участь у голосуванні на виборчій дільниці","13) К-сть бюлетенів, визнаних недійсними","14) Сумарна к-сть голосів виборців ЗА","Грушевський
Віталій
Анатолійович","Дем’янчук
Вікторія
Олександрівна","Діденко
Олег
Валентинович","Колючий
Володимир
Данилович","Кропівка
Анатолій
Федосійович","Литвин
Юрій
Олексійович","Маральов
Юрій
Васильович","Ролінський
Володимир
Іванович","Супрун
Людмила
Павлівна","Сухін
Юрій
Михайлович","Чорноіваненко
Олександр
Анатолійович","Дата підписання протоколу"
"350065","101","Кіровоградська область","школа №3, фойє
вул.Шкільна, 11, м.Гайворон, Гайворонський р-н, Кіровоградська обл., 26300","1458","691","1450","46","721","46","767","","0","721","46","767","20","747","247","33","99","2","0","31","2","1","95","78","159","29.10.12"
"350066","101","Кіровоградська область","комбінат комунальних послуг, каб.1А
вул.Запотоцького, 3, м.Гайворон, Гайворонський р-н, Кіровоградська обл., 26300","1086","477","1090","40","577","32","609","","0","577","32","609","13","596","110","40","70","4","0","22","1","5","93","93","158","29.10.12"
"350067","101","Кіровоградська область","машинобудівний технікум, новий корпус, коридор
вул.Карла Маркса, 94, м.Гайворон, Гайворонський р-н, Кіровоградська обл., 26300","1548","699","1557","36","817","32","849","","0","817","32","849","35","814","128","58","112","2","6","36","0","9","114","156","193","29.10.12"
"350068","101","Кіровоградська область","молодіжний клуб ""Оріон"", зал
вул.Леніна, 37, м.Гайворон, Гайворонський р-н, Кіровоградська обл., 26300","2460","1168","2404","58","1249","43","1292","","0","1249","43","1292","21","1271","197","115","148","2","4","34","7","4","142","301","317","29.10.12"
"350069","101","Кіровоградська область","професійний аграрний ліцей, їдальня
вул.Чапаєва, 14, м.Гайворон, Гайворонський р-н, Кіровоградська обл., 26300","1728","795","1707","27","909","24","933","","0","909","24","933","30","903","114","78","134","3","4","35","3","3","67","216","246","29.10.12"
"350070","101","Кіровоградська область","районний будинок культури, фойє
вул.Кірова, 17, м.Гайворон, Гайворонський р-н, Кіровоградська обл., 26300","2148","1015","2139","30","1107","26","1133","","0","1107","26","1133","28","1105","145","45","131","10","4","58","2","5","110","300","295","29.10.12"
"350071","101","Кіровоградська область","школа №1, хол
вул.Куйбишева, 74, м.Гайворон, Гайворонський р-н, Кіровоградська обл., 26300","1962","914","1934","46","1014","34","1048","","0","1014","34","1048","28","1020","161","60","118","9","4","34","6","10","82","209","327","29.10.12"
"350072","101","Кіровоградська область","школа, каб.1Б
вул.40 років Перемоги, 8, смт Завалля, Гайворонський р-н, Кіровоградська обл., 26334","1662","736","1636","37","891","35","926","","0","891","35","926","27","899","345","64","128","4","6","33","15","0","70","47","187","29.10.12"
"350073","101","Кіровоградська область","управління ПАТ ЗКГ, каб.2
вул.Жовтнева, 14, смт Завалля, Гайворонський р-н, Кіровоградська обл., 26334","1536","752","1512","29","756","28","784","","0","756","28","784","21","763","233","32","115","2","2","31","7","4","66","49","222","29.10.12"
"350074","101","Кіровоградська область","будинок культури, зала
вул.Леніна, 14, смт Завалля, Гайворонський р-н, Кіровоградська обл., 26334","504","145","534","34","328","31","359","","0","328","31","359","15","344","150","12","40","3","3","16","9","0","21","21","69","29.10.12"
"350075","101","Кіровоградська область","будинок культури, мала зала
вул.Заводська, 2, смт Салькове, Гайворонський р-н, Кіровоградська обл., 26332","1296","467","1291","95","734","95","829","","0","734","95","829","26","803","319","70","43","6","2","33","4","1","78","63","184","29.10.12"
"350076","101","Кіровоградська область","будинок культури, вестибюль
вул.Леніна, 147, с.Бандурове, Гайворонський р-н, Кіровоградська обл., 26325","1290","513","1269","146","648","129","777","","0","648","129","777","35","742","276","28","63","4","3","48","4","2","73","120","121","29.10.12"
"350077","101","Кіровоградська область","сільська рада, каб.2
вул.Леніна, 30, с.Берестяги, Гайворонський р-н, Кіровоградська обл., 26311","342","123","339","17","204","15","219","","0","204","15","219","11","208","79","14","18","1","0","15","0","1","22","15","43","29.10.12"
"350078","101","Кіровоградська область","сільська рада, каб.2
вул.Леніна, 6, с.Вікнина, Гайворонський р-н, Кіровоградська обл., 26310","582","194","576","55","333","55","388","","0","333","55","388","13","375","112","23","21","4","0","25","0","1","54","36","99","28.10.12"
"350079","101","Кіровоградська область","будинок культури, урочистий зал
вул.Зімоліна, 9, с.Долинівка, Гайворонський р-н, Кіровоградська обл., 26313","732","242","717","83","409","81","490","","0","409","81","490","16","474","177","16","27","0","1","20","1","3","53","80","96","10.11.12"
"350080","101","Кіровоградська область","будинок культури, зала
вул.Радгоспна, 6, с.Жакчик, Гайворонський р-н, Кіровоградська обл., 26334","252","81","245","12","160","11","171","","0","160","11","171","4","167","39","10","16","1","2","10","0","1","50","8","30","28.10.12"
"350081","101","Кіровоградська область","школа, спортивний зал
вул.Шкільна, 18, с.Казавчин, Гайворонський р-н, Кіровоградська обл., 26322","744","270","724","58","416","58","474","","0","416","58","474","18","456","129","12","31","1","3","41","12","2","107","43","75","29.10.12"
"350082","101","Кіровоградська область","сільська бібліотека, читальний зал
вул.Горького, 61, с.Бугове, Гайворонський р-н, Кіровоградська обл., 26328","258","98","252","17","143","17","160","","0","143","17","160","5","155","23","11","9","0","0","5","1","0","7","68","31","29.10.12"
"350083","101","Кіровоградська область","будинок культури, зала
вул.Котовського, 70, с.Котовка, Гайворонський р-н, Кіровоградська обл., 26324","492","155","488","52","286","51","337","","0","286","51","337","14","323","116","12","29","0","1","13","1","3","42","44","62","28.10.12"
"350084","101","Кіровоградська область","будинок культури, каб.2
вул.Леніна, 95, с.Могильне, Гайворонський р-н, Кіровоградська обл., 26333","642","246","641","49","348","48","396","","0","348","48","396","9","387","98","14","28","2","0","41","0","1","97","37","69","29.10.12"
"350085","101","Кіровоградська область","клуб ПОСП ""Славутич"", каб.2
вул.Щорса, 48, с.Могильне, Гайворонський р-н, Кіровоградська обл., 26333","930","334","916","64","539","57","596","","0","539","57","596","17","579","200","27","20","4","4","24","2","1","81","57","159","29.10.12"
"350086","101","Кіровоградська область","будинок культури, фойє
вул.Карла Маркса, 22, с.Мощене, Гайворонський р-н, Кіровоградська обл., 26314","498","126","490","32","340","32","372","","0","340","32","372","18","354","133","14","10","1","1","16","1","0","71","49","58","28.10.12"
"350087","101","Кіровоградська область","сільська рада, каб.5
вул.Центральна, 7, с.Солгутове, Гайворонський р-н, Кіровоградська обл., 26320","1086","397","1077","53","641","48","689","","0","641","48","689","20","669","184","31","77","4","2","38","4","1","58","96","174","29.10.12"
"350088","101","Кіровоградська область","сільська рада, каб.3
вул.Чапаєва, 23-А, с.Соломія, Гайворонський р-н, Кіровоградська обл., 26321","342","121","340","19","202","19","221","","0","202","19","221","7","214","80","12","8","1","0","20","1","0","17","29","46","28.10.12"
"350089","101","Кіровоградська область","адміністративне приміщення, контора, 2-й поверх, каб.11
вул.8-го Березня, 1, с.Таужне, Гайворонський р-н, Кіровоградська обл., 26330","1362","529","1346","141","702","131","833","","0","702","131","833","17","816","286","32","60","5","4","48","7","3","95","103","173","29.10.12"
"350090","101","Кіровоградська область","будинок культури, фойє
вул.Комуністична, 22, с.Тополі, Гайворонський р-н, Кіровоградська обл., 26315","366","119","357","31","216","31","247","","0","216","31","247","10","237","84","8","16","2","4","23","2","1","7","29","61","29.10.12"
"350091","101","Кіровоградська область","будинок культури, урочиста зала
вул.Леніна, 48, с.Хащувате, Гайворонський р-н, Кіровоградська обл., 26331","1632","643","1617","70","927","62","989","","0","927","62","989","41","948","185","40","112","3","3","78","9","8","128","170","212","29.10.12"
"350092","101","Кіровоградська область","будинок культури, фойє
вул.Ценральна, 3, с.Чемерпіль, Гайворонський р-н, Кіровоградська обл., 26335","660","171","648","38","454","35","489","","0","454","35","489","11","478","191","10","19","1","2","31","6","0","118","16","84","29.10.12"
"350093","101","Кіровоградська область","будинок культури, зала
вул.Леніна, 36, с.Березівка, Гайворонський р-н, Кіровоградська обл., 26335","222","104","219","17","105","13","118","","0","105","13","118","4","114","36","5","11","1","0","2","1","0","26","5","27","10.11.12"
"350094","101","Кіровоградська область","школа, каб.7
вул.Центральна, 9, с.Червоне, Гайворонський р-н, Кіровоградська обл., 26312","786","286","769","45","457","43","500","","0","457","43","500","18","482","95","17","50","1","2","35","6","3","121","45","107","28.10.12"
"350095","101","Кіровоградська область","СТК ОСО Україна, вестибюль ""ДОСААФ""
вул.Леніна, 88А, смт Голованівськ, Голованівський р-н, Кіровоградська обл., 26500","1464","589","1438","46","829","46","875","","0","829","46","875","28","847","230","25","198","2","7","43","3","4","117","48","170","29.10.12"
"350096","101","Кіровоградська область","районний будинок культури, фойє
вул.Суворова, 6, смт Голованівськ, Голованівський р-н, Кіровоградська обл., 26500","1848","708","1851","74","1072","68","1140","","0","1072","68","1140","27","1113","344","20","197","5","5","83","6","6","132","53","262","29.10.12"
"350097","101","Кіровоградська область","ВАТ ""Агропостач"", магазин, торговий зал
вул.Пушкіна, 7А, смт Голованівськ, Голованівський р-н, Кіровоградська обл., 26500","1392","492","1385","25","875","25","900","","0","875","25","900","35","865","213","42","142","4","7","48","3","4","122","38","242","29.10.12"
"350098","101","Кіровоградська область","школа, вестибюль
вул.Радянська, 50, с-ще Голованівськ, Голованівський р-н, Кіровоградська обл., 26508","534","133","533","15","386","15","401","","0","386","15","401","10","391","117","7","40","0","1","44","0","2","103","8","69","28.10.12"
"350099","101","Кіровоградська область","будинок культури, ""Музична вітальня""
вул.Театральна, 4, смт Побузьке, Голованівський р-н, Кіровоградська обл., 26555","2322","1101","2300","37","1187","34","1221","","0","1187","34","1221","31","1190","452","155","146","4","8","60","6","7","125","13","214","29.10.12"
"350100","101","Кіровоградська область","будинок культури, фойє
вул.Театральна, 4, смт Побузьке, Голованівський р-н, Кіровоградська обл., 26555","2328","1064","2298","42","1232","32","1264","","0","1232","32","1264","19","1245","567","152","141","5","2","59","6","8","126","6","173","29.10.12"
"350101","101","Кіровоградська область","сільський будинок культури, актова зала
вул.Івана Франка, 34, с.Вербове, Голованівський р-н, Кіровоградська обл., 26509","366","103","353","28","236","27","263","","0","236","27","263","8","255","84","5","15","0","0","10","1","1","95","3","41","28.10.12"
"350102","101","Кіровоградська область","сільський будинок культури, зал
вул.Миру, 12А, с.Грузьке, Голованівський р-н, Кіровоградська обл., 26526","690","107","683","45","538","45","583","","0","538","45","583","5","578","430","0","0","0","0","10","18","30","40","15","35","28.10.12"
"350103","101","Кіровоградська область","сільський будинок культури, глядацька зала
вул.Леніна, 30, с.Ємилівка, Голованівський р-н, Кіровоградська обл., 26532","450","145","454","31","274","31","305","","0","274","31","305","5","300","141","13","22","2","0","15","0","0","68","5","34","28.10.12"
"350104","101","Кіровоградська область","навчально-виховний комплекс, спортивний зал
вул.Енгельса, 1, с-ще Ємилівка, Голованівський р-н, Кіровоградська обл., 26533","402","104","406","29","271","27","298","","0","271","27","298","5","293","102","13","32","0","2","28","10","1","30","5","70","29.10.12"
"350105","101","Кіровоградська область","сільський будинок культури, актова зала
вул.Зарічна, 7А, с.Журавлинка, Голованівський р-н, Кіровоградська обл., 26531","414","126","429","25","265","23","288","","0","265","23","288","7","281","117","17","12","0","1","17","0","1","79","3","34","29.10.12"
"350106","101","Кіровоградська область","сільський будинок культури, актова зала
вул.Леніна, 100, с.Капітанка, Голованівський р-н, Кіровоградська обл., 26554","954","429","956","30","504","21","525","","0","504","21","525","13","512","172","42","60","6","3","57","2","4","65","6","95","28.10.12"
"350107","101","Кіровоградська область","сільський будинок культури, актова зала
вул.Терешкової, 29, с.Клинове, Голованівський р-н, Кіровоградська обл., 26525","588","96","605","15","478","14","492","","0","478","14","492","12","480","213","6","16","1","0","22","0","4","184","0","34","08.11.12"
"350108","101","Кіровоградська область","сільський будинок культури, актова зала
вул.Тельмана, 51, с.Красногірка, Голованівський р-н, Кіровоградська обл., 26540","528","170","524","47","314","44","358","","0","314","44","358","12","346","121","20","38","2","1","35","1","0","69","22","37","28.10.12"
"350109","101","Кіровоградська область","сільський будинок культури, актова зала
вул.Леніна, 3, с.Крутеньке, Голованівський р-н, Кіровоградська обл., 26520","492","115","479","50","327","50","377","","0","327","50","377","13","364","148","7","22","1","1","41","0","2","96","3","43","28.10.12"
"350110","101","Кіровоградська область","сільська рада, актова зала
вул.Шкільна, 1, с.Лебединка, Голованівський р-н, Кіровоградська обл., 26524","432","126","426","53","253","53","306","","0","253","53","306","13","293","141","2","12","0","2","17","1","1","66","8","43","28.10.12"
"350111","101","Кіровоградська область","сільська рада, актова зала
вул.Шубіна, 1, с.Липовеньке, Голованівський р-н, Кіровоградська обл., 26552","432","125","449","40","267","40","307","","0","267","40","307","2","305","124","9","17","0","3","38","2","1","59","3","49","29.10.12"
"350112","101","Кіровоградська область","школа, актова зала
вул.Центральна, 4, с.Люшнювате, Голованівський р-н, Кіровоградська обл., 26544","366","113","367","29","224","29","253","","0","224","29","253","5","248","152","4","17","1","0","26","0","1","25","3","19","28.10.12"
"350113","101","Кіровоградська область","сільська рада, актова зала
вул.К.Маркса, 22, с.Межирічка, Голованівський р-н, Кіровоградська обл., 26510","876","348","868","23","509","19","528","","0","509","19","528","4","524","296","6","38","2","2","24","2","1","56","7","90","29.10.12"
"350114","101","Кіровоградська область","сільський клуб, актова зала
вул.Леніна, 2, с.Краснопілля, Голованівський р-н, Кіровоградська обл., 26511","156","43","150","6","108","5","113","","0","108","5","113","2","111","49","2","6","0","0","8","0","0","22","4","20","29.10.12"
"350115","101","Кіровоградська область","сільський будинок культури, глядацька зала
вул.Суворова, 65, с.Молдовка, Голованівський р-н, Кіровоградська обл., 26543","456","129","460","35","298","29","327","","0","298","29","327","5","322","80","9","46","3","4","43","1","1","67","8","60","28.10.12"
"350116","101","Кіровоградська область","контора АФ ""Хлібороб"" ТОВ, актова зала
вул.Центральна, 3, с.Наливайка, Голованівський р-н, Кіровоградська обл., 26512","438","143","429","16","279","16","295","","0","279","16","295","0","295","147","10","17","1","1","19","0","0","71","3","26","28.10.12"
"350117","101","Кіровоградська область","магазин, к.1
вул.Кошового, 24, с.Перегонівка, Голованівський р-н, Кіровоградська обл., 26522","858","349","873","21","488","21","509","","0","488","21","509","17","492","140","18","44","3","3","48","0","3","113","9","111","28.10.12"
"350118","101","Кіровоградська область","сільський будинок культури, фойє
вул.Енгельса, 11, с.Перегонівка, Голованівський р-н, Кіровоградська обл., 26522","1542","667","1534","95","782","93","875","","0","782","93","875","21","854","271","30","88","1","6","42","0","15","185","3","213","28.10.12"
"350119","101","Кіровоградська область","школа, їдальня
вул.Шевченка, 25, с.Полонисте, Голованівський р-н, Кіровоградська обл., 26523","228","69","222","10","149","10","159","","0","149","10","159","5","154","77","3","5","0","3","22","1","10","14","3","16","29.10.12"
"350120","101","Кіровоградська область","сільський клуб, фойє
вул.Польова, 3, с.Давидівка, Голованівський р-н, Кіровоградська обл., 26523","138","35","137","14","90","13","103","","0","90","13","103","5","98","58","1","6","0","2","9","0","1","10","1","10","28.10.12"
"350121","101","Кіровоградська область","дошкільний навчальний заклад, актова зала
вул.Данилюка, 26, с.Пушкове, Голованівський р-н, Кіровоградська обл., 26553","336","105","331","15","217","14","231","","0","217","14","231","3","228","135","5","12","0","1","13","0","0","23","3","36","28.10.12"
"350122","101","Кіровоградська область","сільський клуб, глядацька зала
вул.Леніна, 44, с.Новосілка, Голованівський р-н, Кіровоградська обл., 26551","408","86","411","43","279","43","322","","0","279","43","322","2","320","175","27","10","1","2","24","0","3","42","2","34","29.10.12"
"350123","101","Кіровоградська область","навчально-виховний комплекс, актова зала
вул.Садова, 31, с.Розкішне, Голованівський р-н, Кіровоградська обл., 26550","186","38","185","21","130","18","148","","0","130","18","148","6","142","79","9","7","0","2","5","0","0","19","2","19","08.11.12"
"350124","101","Кіровоградська область","сільський клуб, фойє
вул.Каньовського, 34, с.Маринопіль, Голованівський р-н, Кіровоградська обл., 26551","120","30","119","18","73","17","90","","0","73","17","90","6","84","39","9","2","1","1","12","0","1","5","0","14","29.10.12"
"350125","101","Кіровоградська область","сільський клуб, актова зала
вул.Одеська, 1, с.Роздол, Голованівський р-н, Кіровоградська обл., 26541","312","99","305","15","199","14","213","","0","199","14","213","8","205","90","6","17","0","1","25","1","3","29","5","28","28.10.12"
"350126","101","Кіровоградська область","сільський будинок культури, березова зала
вул.Перемоги, 25, с.Свірневе, Голованівський р-н, Кіровоградська обл., 26542","612","273","602","14","325","14","339","","0","325","14","339","14","325","95","5","43","2","0","22","2","0","128","7","21","28.10.12"
"350127","101","Кіровоградська область","школа, вестибюль
вул.Шкільна, 3, с.Семидуби, Голованівський р-н, Кіровоградська обл., 26521","282","77","280","25","185","20","205","","0","185","20","205","4","201","114","3","9","0","0","11","0","0","46","2","16","28.10.12"
"350128","101","Кіровоградська область","сільська рада, зал засідань
вул.Центральна, 25, с.Троянка, Голованівський р-н, Кіровоградська обл., 26530","546","200","539","38","312","34","346","","0","312","34","346","6","340","203","7","18","0","1","28","0","1","43","6","33","28.10.12"
"350129","101","Кіровоградська область","школа, спортивна зала
вул.Леніна, 1А, с.Шепилове, Голованівський р-н, Кіровоградська обл., 26534","534","186","526","15","333","15","348","","0","333","15","348","6","342","124","6","31","2","1","25","0","0","80","9","64","28.10.12"
"350322","101","Кіровоградська область","ветеринарна лікарня, актова зала
вул.Горького, 30, м.Мала Виска, Маловисківський р-н, Кіровоградська обл., 26200","1620","817","1593","31","773","30","803","","0","773","30","803","32","771","261","44","62","2","1","19","5","3","150","45","179","28.10.12"
"350323","101","Кіровоградська область","школа №3, вестибюль
вул.20 років Жовтня, 3, м.Мала Виска, Маловисківський р-н, Кіровоградська обл., 26200","2118","1014","2028","104","1048","56","1104","","0","1048","56","1104","28","1076","364","76","120","5","6","33","10","3","163","67","229","08.11.12"
"350324","101","Кіровоградська область","районний будинок культури, танцювальна зала
вул.Жовтнева, 63, м.Мала Виска, Маловисківський р-н, Кіровоградська обл., 26200","1728","804","1708","41","900","24","924","","0","900","24","924","27","897","237","79","92","4","8","14","10","4","166","54","229","29.10.12"
"350325","101","Кіровоградська область","професійно-технічне училище №16, вестибюль
вул.Шевченка, 56/1, м.Мала Виска, Маловисківський р-н, Кіровоградська обл., 26200","960","474","950","8","480","6","486","","0","480","6","486","12","474","148","21","56","0","1","21","1","0","82","19","125","29.10.12"
"350326","101","Кіровоградська область","районний агротехсервіс, актова зала
пров.Авіаційний, 1Б, м.Мала Виска, Маловисківський р-н, Кіровоградська обл., 26200","1368","754","1363","21","594","20","614","","0","594","20","614","20","594","186","42","60","4","3","16","2","1","119","26","135","29.10.12"
"350327","101","Кіровоградська область","школа №4, коридор, 1-й поверх
вул.40 років Жовтня, 17, м.Мала Виска, Маловисківський р-н, Кіровоградська обл., 26200","1530","845","1515","24","667","18","685","","0","667","18","685","20","665","216","44","57","0","2","29","2","0","112","47","156","28.10.12"
"350328","101","Кіровоградська область","дитячий садок ""Ластівка"", ігрова кімната
вул.Садова, 3, с-ще Комсомольське, Маловисківський р-н, Кіровоградська обл., 26200","132","65","124","0","67","0","67","","0","67","0","67","3","64","10","1","7","1","0","4","0","0","26","0","15","28.10.12"
"350329","101","Кіровоградська область","школа, вестибюль
пров.Мічуріна, 9, с.Краснопілка, Маловисківський р-н, Кіровоградська обл., 26205","276","121","275","13","142","13","155","","0","142","13","155","2","153","43","8","10","3","0","20","1","0","26","3","39","28.10.12"
"350330","101","Кіровоградська область","селищний клуб, глядацька зала
вул.50 років Жовтня, 23/24, с-ще Улянівка, Маловисківський р-н, Кіровоградська обл., 26200","210","85","210","0","125","0","125","","0","125","0","125","3","122","50","9","3","0","2","16","0","2","9","3","28","28.10.12"
"350331","101","Кіровоградська область","управління геолого-розвідувальної експедиції №47, кімната бухгалтерії
вул.Геологів, 79, смт Смоліне, Маловисківський р-н, Кіровоградська обл., 26223","822","381","812","10","432","9","441","","0","432","9","441","8","433","190","38","40","4","1","17","0","2","52","23","66","29.10.12"
"350332","101","Кіровоградська область","школа №1, їдальня
вул.Будівельників, 1, смт Смоліне, Маловисківський р-н, Кіровоградська обл., 26223","744","322","760","19","406","16","422","","0","406","16","422","11","411","177","16","43","8","1","7","4","3","77","13","62","29.10.12"
"350333","101","Кіровоградська область","дитячо-юнацький центр, вестибюль
вул.Казакова, 33, смт Смоліне, Маловисківський р-н, Кіровоградська обл., 26223","2100","1067","2070","7","1026","7","1033","","0","1026","7","1033","12","1021","518","34","79","8","6","33","10","4","90","54","185","29.10.12"
"350334","101","Кіровоградська область","гуртожиток шахти, актова зала
вул.Казакова, 10, смт Смоліне, Маловисківський р-н, Кіровоградська обл., 26223","1902","954","1877","17","937","11","948","","0","937","11","948","32","916","472","40","72","1","6","20","8","8","68","52","169","29.10.12"
"350335","101","Кіровоградська область","будинок культури, актова зала
вул.Ватутіна, будинок культури, с.Березівка, Маловисківський р-н, Кіровоградська обл., 26222","774","358","767","64","359","57","416","","0","359","57","416","12","404","131","29","37","1","8","19","2","3","80","13","81","29.10.12"
"350336","101","Кіровоградська область","будинок культури, танцювальна зала
вул.Леніна, 84, с.Велика Виска, Маловисківський р-н, Кіровоградська обл., 26241","1698","764","1675","88","857","77","934","","0","857","77","934","26","908","410","57","92","5","5","101","1","4","63","23","147","29.10.12"
"350337","101","Кіровоградська область","будинок культури, фойє
вул.Жовтнева, будинок культури, с.Злинка, Маловисківський р-н, Кіровоградська обл., 26232","1074","661","1072","17","396","17","413","","0","396","17","413","13","400","110","26","41","2","4","37","2","0","109","19","50","28.10.12"
"350338","101","Кіровоградська область","сільський клуб, танцювальна зала
вул.Пушкіна, сільський клуб, с.Злинка, Маловисківський р-н, Кіровоградська обл., 26232","732","383","736","20","329","20","349","","0","329","20","349","17","332","100","37","61","0","1","17","0","0","83","3","30","28.10.12"
"350339","101","Кіровоградська область","контора ТОВ ""Дружба"", коридор
пров.Свердлова, контора ТОВ ""Дружба"", с.Злинка, Маловисківський р-н, Кіровоградська обл., 26232","834","510","810","28","301","23","324","","0","301","23","324","21","303","64","59","28","4","5","26","0","1","80","10","26","28.10.12"
"350340","101","Кіровоградська область","клуб АФ ""Злинська"", танцювальна зала
вул.Свердлова, клуб АФ ""Злинська"", с.Злинка, Маловисківський р-н, Кіровоградська обл., 26232","606","272","592","36","298","36","334","","0","298","36","334","9","325","128","26","25","2","1","19","0","1","56","9","58","28.10.12"
"350341","101","Кіровоградська область","будинок культури, глядацька зала
вул.Карла Маркса, 16, с.Кіровка, Маловисківський р-н, Кіровоградська обл., 26213","480","188","470","28","266","26","292","","0","266","26","292","10","282","53","43","16","0","0","21","6","0","64","7","72","28.10.12"
"350342","101","Кіровоградська область","будинок культури, глядацька зала
вул.Центральна, 19, с.Леніна, Маловисківський р-н, Кіровоградська обл., 26211","132","41","126","4","87","4","91","","0","87","4","91","3","88","13","7","2","1","0","9","1","1","17","5","32","29.10.12"
"350343","101","Кіровоградська область","сільський клуб, глядацька зала
вул.Шевченка, 24, с.Копанки, Маловисківський р-н, Кіровоградська обл., 26212","372","142","364","8","225","5","230","","0","225","5","230","7","223","85","7","6","1","0","17","0","1","27","25","54","08.11.12"
"350344","101","Кіровоградська область","сільський магазин, торгова зала
вул.Леніна, сільський магазин, с.Лозуватка, Маловисківський р-н, Кіровоградська обл., 26230","624","237","616","26","364","23","387","","0","364","23","387","7","380","144","26","23","2","5","22","5","1","75","27","50","29.10.12"
"350345","101","Кіровоградська область","сільський клуб, танцювальна зала
вул.Кузнєцова, 18, с.Димине, Маловисківський р-н, Кіровоградська обл., 26230","72","22","74","2","48","2","50","","0","48","2","50","0","50","17","1","3","0","0","7","0","0","13","0","9","29.10.12"
"350346","101","Кіровоградська область","будинок культури, мала зала
вул.Водолазко, 67, с.Мануйлівка, Маловисківський р-н, Кіровоградська обл., 26207","534","195","519","42","302","37","339","","0","302","37","339","15","324","136","19","41","0","4","21","1","1","45","11","45","29.10.12"
"350347","101","Кіровоградська область","сільський клуб, актова зала
вул.Шевченка, 16, с.Лутківка, Маловисківський р-н, Кіровоградська обл., 26207","150","37","153","6","107","6","113","","0","107","6","113","1","112","94","4","5","0","1","0","1","0","0","1","6","29.10.12"
"350348","101","Кіровоградська область","будинок культури, вестибюль
просп.Ілліча, 14, с.Мар’янівка, Маловисківський р-н, Кіровоградська обл., 26240","1224","566","1212","67","597","61","658","","0","597","61","658","30","628","228","137","51","3","5","39","3","2","75","13","72","29.10.12"
"350349","101","Кіровоградська область","дитячий садок ""Вишенька"", кабінет завідуючої
вул.Ватутіна, 1, с.Олексіївка, Маловисківський р-н, Кіровоградська обл., 26240","162","55","162","13","94","13","107","","0","94","13","107","7","100","44","13","8","0","0","27","0","1","1","2","4","29.10.12"
"350350","101","Кіровоградська область","сільський клуб, танцювальна зала
вул.Графська, 1, с.Нововознесенка, Маловисківський р-н, Кіровоградська обл., 26221","318","124","311","21","174","20","194","","0","174","20","194","7","187","35","11","16","0","2","10","10","0","40","13","50","29.10.12"
"350351","101","Кіровоградська область","будинок культури, глядацька зала
вул.Кірова, 1А, с.Новогригорівка, Маловисківський р-н, Кіровоградська обл., 26227","744","341","735","62","357","46","403","","0","357","46","403","8","395","122","20","25","4","4","32","4","1","56","35","92","29.10.12"
"350352","101","Кіровоградська область","будинок культури, фойє
вул.Жовтнева, 1, с.Олександрівка, Маловисківський р-н, Кіровоградська обл., 26243","540","231","540","21","294","15","309","","0","294","15","309","17","292","129","19","15","2","3","22","2","0","60","11","29","29.10.12"
"350353","101","Кіровоградська область","сільський клуб, фойє
вул.Жовтнева, 18, с.Оникієве, Маловисківський р-н, Кіровоградська обл., 26244","1200","500","1188","71","639","61","700","","0","639","61","700","14","686","317","78","52","2","2","83","2","3","75","12","60","29.10.12"
"350354","101","Кіровоградська область","школа, коридор, 1-й поверх
вул.Шкільна, 1, с.Паліївка, Маловисківський р-н, Кіровоградська обл., 26206","912","343","900","71","505","64","569","","0","505","64","569","13","556","226","40","21","0","4","34","0","1","92","19","119","28.10.12"
"350355","101","Кіровоградська область","школа, актова зала
вул.Малахівська, 2, с.Первомайське, Маловисківський р-н, Кіровоградська обл., 26210","234","84","224","47","108","42","150","","0","108","42","150","2","148","25","33","11","1","0","18","0","0","26","9","25","28.10.12"
"350356","101","Кіровоградська область","будинок культури, фойє
вул.Радянська, 30, с.Плетений Ташлик, Маловисківський р-н, Кіровоградська обл., 26245","954","446","944","54","458","50","508","","0","458","50","508","16","492","158","150","32","3","6","21","1","3","58","8","52","10.11.12"
"350357","101","Кіровоградська область","сільський клуб, глядацька зала
вул.Садова, 1, с.Первомайськ, Маловисківський р-н, Кіровоградська обл., 26245","282","90","283","22","172","20","192","","0","172","20","192","4","188","37","25","27","4","0","23","0","0","32","7","33","29.10.12"
"350358","101","Кіровоградська область","будинок культури, танцювальна зала
вул.Горького, 4, с.Розсохуватка, Маловисківський р-н, Кіровоградська обл., 26231","408","140","402","26","245","23","268","","0","245","23","268","8","260","104","35","10","0","3","18","3","0","48","8","31","29.10.12"
"350359","101","Кіровоградська область","школа, їдальня
вул.Калініна, 51, с.Хмельове, Маловисківський р-н, Кіровоградська обл., 26225","534","209","531","16","311","14","325","","0","311","14","325","9","316","86","10","21","3","3","7","0","4","85","11","86","29.10.12"
"350360","101","Кіровоградська область","школа, фойє
вул.Комсомольська, 26, с.Хмельове, Маловисківський р-н, Кіровоградська обл., 26225","1170","474","1165","32","664","32","696","","0","664","32","696","23","673","222","33","50","6","7","15","1","3","108","40","188","29.10.12"
"350361","101","Кіровоградська область","фельдшерсько-акушерський пункт, вестибюль
вул.Центральна, 15, с.Леніно-Ульяновка, Маловисківський р-н, Кіровоградська обл., 26229","72","18","76","8","46","8","54","","0","46","8","54","0","54","41","1","0","0","0","6","0","0","2","0","4","28.10.12"
"350362","101","Кіровоградська область","школа, вестибюль
вул.Шкільна, 11, с.Новопавлівка, Маловисківський р-н, Кіровоградська обл., 26228","240","86","235","14","142","12","154","","0","142","12","154","5","149","27","9","10","5","1","13","0","0","37","8","39","29.10.12"
"350363","101","Кіровоградська область","будинок культури, фойє
вул.Молодіжна, 10А, с.Якимівка, Маловисківський р-н, Кіровоградська обл., 26220","384","167","372","45","172","45","217","","0","172","45","217","5","212","80","34","5","4","0","12","0","0","54","2","21","29.10.12"
"350386","101","Кіровоградська область","будинок культури, фойє
вул.Леніна, 42, смт Новоархангельськ, Новоархангельський р-н, Кіровоградська обл., 26100","1476","635","1473","25","820","21","841","","0","820","21","841","24","817","193","42","63","30","16","49","5","3","221","30","165","29.10.12"
"350387","101","Кіровоградська область","будинок культури №2, зал
вул.Слави, 101, смт Новоархангельськ, Новоархангельський р-н, Кіровоградська обл., 26100","1758","748","1765","23","992","18","1010","","0","992","18","1010","29","981","143","47","97","11","18","66","19","4","245","33","298","08.11.12"
"350388","101","Кіровоградська область","будинок культури №3, фойє
вул.Жебровського, 105, смт Новоархангельськ, Новоархангельський р-н, Кіровоградська обл., 26100","750","430","731","22","298","22","320","","0","298","22","320","18","302","57","10","31","2","3","39","2","4","86","5","63","28.10.12"
"350389","101","Кіровоградська область","ТОВ ""Агробуд"", зал засідань
вул.Леніна, 136, смт Новоархангельськ, Новоархангельський р-н, Кіровоградська обл., 26100","2010","927","2003","49","1037","46","1083","","0","1037","46","1083","24","1059","160","56","95","15","15","114","4","3","342","26","229","29.10.12"
"350390","101","Кіровоградська область","будинок культури, зал
вул.Слави, 61, с.Синюха, Новоархангельський р-н, Кіровоградська обл., 26105","366","113","371","25","233","20","253","","0","233","20","253","13","240","39","20","19","8","0","96","0","0","35","0","23","28.10.12"
"350391","101","Кіровоградська область","будинок культури, фойє
пров.Шкільний, 15, с.Солдатське, Новоархангельський р-н, Кіровоградська обл., 26100","60","20","60","1","39","1","40","","0","39","1","40","1","39","5","2","0","0","0","16","0","0","3","1","12","28.10.12"
"350392","101","Кіровоградська область","сільська рада, фойє
вул.Леніна, 49, с.Вільшанка, Новоархангельський р-н, Кіровоградська обл., 26153","360","125","351","20","215","20","235","","0","215","20","235","11","224","59","9","11","7","1","29","0","0","70","6","32","29.10.12"
"350393","101","Кіровоградська область","школа, актова зала
вул.Наумова, 4, с.Шляхове, Новоархангельський р-н, Кіровоградська обл., 26153","108","30","107","8","70","8","78","","0","70","8","78","4","74","24","4","2","1","0","29","0","0","1","1","12","28.10.12"
"350394","101","Кіровоградська область","будинок культури, фойє
вул.Центральна, 7, с.Ганнівка, Новоархангельський р-н, Кіровоградська обл., 26142","378","93","371","32","253","32","285","","0","253","32","285","3","282","206","7","4","1","3","27","0","0","10","8","16","28.10.12"
"350395","101","Кіровоградська область","будинок культури, фойє
вул.Шкільна, 9, с.Іванівка, Новоархангельський р-н, Кіровоградська обл., 26151","468","165","459","32","273","30","303","","0","273","30","303","8","295","55","4","13","38","0","19","44","2","48","5","67","29.10.12"
"350396","101","Кіровоградська область","сільська рада, фойє
вул.Леніна, 82, с.Кальниболота, Новоархангельський р-н, Кіровоградська обл., 26111","990","469","974","31","493","28","521","","0","493","28","521","17","504","67","7","17","7","5","31","0","1","310","10","49","28.10.12"
"350397","101","Кіровоградська область","будинок культури, фойє
вул.Лисова, 56, с.Кам’янече, Новоархангельський р-н, Кіровоградська обл., 26110","1092","382","1078","78","636","74","710","","0","636","74","710","19","691","172","23","56","20","60","26","2","2","218","11","101","29.10.12"
"350398","101","Кіровоградська область","будинок культури, зал
вул.Леніна, 17, с.Копенкувате, Новоархангельський р-н, Кіровоградська обл., 26123","594","169","585","45","381","44","425","","0","381","44","425","7","418","154","8","37","6","13","58","0","1","93","2","46","29.10.12"
"350399","101","Кіровоградська область","будинок культури, зал
вул.Ковпака, 1, с.Борщова, Новоархангельський р-н, Кіровоградська обл., 26123","108","37","102","10","61","10","71","","0","61","10","71","3","68","23","4","7","0","2","3","1","0","21","0","7","29.10.12"
"350400","101","Кіровоградська область","будинок культури, фойє
вул.Петровського, 42, с.Мартинівка, Новоархангельський р-н, Кіровоградська обл., 26143","204","55","203","10","139","10","149","","0","139","10","149","4","145","67","1","1","0","0","5","1","0","26","2","42","28.10.12"
"350401","101","Кіровоградська область","будинок культури, фойє
вул.Центральна, 6, с.Мар’янівка, Новоархангельський р-н, Кіровоградська обл., 26141","330","55","324","31","244","31","275","","0","244","31","275","5","270","201","5","6","3","0","4","0","0","20","4","27","28.10.12"
"350402","101","Кіровоградська область","будинок культури, фойє
вул.Адміністративна, 6, с.Надлак, Новоархангельський р-н, Кіровоградська обл., 26150","1194","560","1180","53","590","44","634","","0","590","44","634","22","612","167","12","88","31","13","29","23","2","79","48","120","29.10.12"
"350403","101","Кіровоградська область","будинок культури, фойє
вул.Подільська, 5А, с.Тимофіївка, Новоархангельський р-н, Кіровоградська обл., 26152","264","101","258","27","136","27","163","","0","136","27","163","10","153","39","15","3","1","0","57","0","0","21","3","14","28.10.12"
"350404","101","Кіровоградська область","будинок культури, фойє
вул.Леніна, 30, с.Небелівка, Новоархангельський р-н, Кіровоградська обл., 26121","390","108","388","24","259","23","282","","0","259","23","282","20","262","68","12","15","5","4","30","0","3","56","6","63","28.10.12"
"350405","101","Кіровоградська область","будинок культури, фойє
вул.Комсомольська, 8, с.Нерубайка, Новоархангельський р-н, Кіровоградська обл., 26120","834","285","820","102","461","88","549","","0","461","88","549","13","536","135","20","27","5","27","28","0","1","210","4","79","29.10.12"
"350406","101","Кіровоградська область","будинок культури, фойє
вул.Пролетарська, 1, с.Підвисоке, Новоархангельський р-н, Кіровоградська обл., 26122","1482","593","1468","93","804","85","889","","0","804","85","889","27","862","181","13","86","29","33","49","0","3","256","13","199","29.10.12"
"350407","101","Кіровоградська область","будинок культури, фойє
вул.Центральна, 11, с.Покотилове, Новоархангельський р-н, Кіровоградська обл., 26132","492","136","493","44","316","40","356","","0","316","40","356","8","348","93","5","12","1","9","22","0","0","153","12","41","28.10.12"
"350408","101","Кіровоградська область","будинок культури, фойє
вул.Перемоги, 3, с.Орлове, Новоархангельський р-н, Кіровоградська обл., 26133","168","25","166","11","132","11","143","","0","132","11","143","3","140","49","4","6","0","1","11","1","0","23","1","44","29.10.12"
"350409","101","Кіровоградська область","будинок культури, фойє
вул.Шкільна, 2, с.Покровка, Новоархангельський р-н, Кіровоградська обл., 26154","192","58","178","10","128","6","134","","0","128","6","134","10","124","43","2","2","2","0","12","0","1","43","4","15","28.10.12"
"350410","101","Кіровоградська область","будинок культури, фойє
вул.Центральна, 8, с.Розсохуватець, Новоархангельський р-н, Кіровоградська обл., 26130","288","76","290","25","190","22","212","","0","190","22","212","6","206","63","12","7","0","25","22","0","2","44","3","28","28.10.12"
"350411","101","Кіровоградська область","будинок культури, фойє
вул.Леніна, 50, с.Скалева, Новоархангельський р-н, Кіровоградська обл., 26112","444","145","428","27","272","27","299","","0","272","27","299","1","298","95","5","18","20","6","25","0","1","88","10","30","29.10.12"
"350412","101","Кіровоградська область","будинок культури, фойє
вул.Центральна, 1, с.Скалівські Хутори, Новоархангельський р-н, Кіровоградська обл., 26140","456","118","451","50","290","48","338","","0","290","48","338","10","328","176","5","12","3","23","13","0","1","37","6","52","29.10.12"
"350413","101","Кіровоградська область","контора ФГ ""Баліцького"", зал
вул.Степова, 6, с.Кринички, Новоархангельський р-н, Кіровоградська обл., 26140","72","19","69","10","43","10","53","","0","43","10","53","1","52","43","0","1","0","0","2","0","0","0","2","4","28.10.12"
"350414","101","Кіровоградська область","будинок культури, фойє
вул.Т.Шевченка, 18, с.Свердликове, Новоархангельський р-н, Кіровоградська обл., 26113","528","136","530","58","338","54","392","","0","338","54","392","6","386","103","15","24","0","8","43","0","0","135","19","39","29.10.12"
"350415","101","Кіровоградська область","будинок культури, фойє
вул.Сонячна, 2А, с.Тернівка, Новоархангельський р-н, Кіровоградська обл., 26131","582","125","577","69","390","67","457","","0","390","67","457","10","447","210","19","13","11","10","33","2","1","72","4","72","28.10.12"
"350416","101","Кіровоградська область","будинок культури, фойє
вул.Івана Сірка, 19, с.Торговиця, Новоархангельський р-н, Кіровоградська обл., 26106","1698","750","1678","62","889","59","948","","0","889","59","948","32","916","259","24","75","7","9","58","4","2","284","29","165","10.11.12"
"350417","101","Кіровоградська область","школа, фойє
вул.Леніна, 7, с.Левківка, Новоархангельський р-н, Кіровоградська обл., 26107","180","44","179","25","111","25","136","","0","111","25","136","4","132","18","5","13","1","2","22","2","0","47","3","19","10.11.12"
"350418","101","Кіровоградська область","будинок культури, фойє
вул.Т.Шевченка, 38, с.Ятрань, Новоархангельський р-н, Кіровоградська обл., 26134","270","67","263","17","187","16","203","","0","187","16","203","5","198","68","5","7","0","2","6","0","0","83","6","21","29.10.12"
"350419","101","Кіровоградська область","школа №1, актова зала
вул.Луначарського, 20, м.Новомиргород, Новомиргородський р-н, Кіровоградська обл., 26000","1518","828","1483","25","670","20","690","","0","670","20","690","17","673","149","39","170","1","2","32","1","11","94","56","118","29.10.12"
"350420","101","Кіровоградська область","міський будинок культури, вітальна зала
вул.Леніна, 304, м.Новомиргород, Новомиргородський р-н, Кіровоградська обл., 26000","1224","621","1216","18","585","18","603","","0","585","18","603","22","581","137","36","107","3","2","34","2","5","59","31","165","29.10.12"
"350421","101","Кіровоградська область","районний будинок культури, фойє
вул.Леніна, 99/12, м.Новомиргород, Новомиргородський р-н, Кіровоградська обл., 26000","2232","1156","2179","49","1039","37","1076","","0","1039","37","1076","51","1025","292","43","152","4","2","32","20","9","100","52","319","08.11.12"
"350422","101","Кіровоградська область","КП ""Новомиргородські муніципальні інженерні мережі"", кабінет по техніці безпеки та охорони праці
вул.Толстого, 27, м.Новомиргород, Новомиргородський р-н, Кіровоградська обл., 26000","1530","774","1512","30","728","28","756","","0","728","28","756","23","733","159","52","109","2","5","43","3","2","64","27","267","29.10.12"
"350423","101","Кіровоградська область","школа №3, актова зала
вул.Леніна, 41, м.Новомиргород, Новомиргородський р-н, Кіровоградська обл., 26000","1800","1005","1777","31","772","23","795","","0","772","23","795","20","775","182","37","112","3","6","29","6","5","126","37","232","10.11.12"
"350424","101","Кіровоградська область","будинок культури, фойє
вул.Сінельнікова, 45/14А, м.Новомиргород, Новомиргородський р-н, Кіровоградська обл., 26000","1554","869","1541","36","657","28","685","","0","657","28","685","17","668","188","20","111","2","5","35","5","3","64","43","192","08.11.12"
"350425","101","Кіровоградська область","ПСП ""Бирзулове"", хол
вул.Чкалова, 1, с.Бирзулове, Новомиргородський р-н, Кіровоградська обл., 26009","72","18","66","13","41","13","54","","0","41","13","54","3","51","13","1","3","0","2","5","0","0","6","3","18","28.10.12"
"350426","101","Кіровоградська область","школа, хол
вул.Миру, 5, с.Лікареве, Новомиргородський р-н, Кіровоградська обл., 26009","90","35","82","7","51","4","55","","0","51","4","55","8","47","12","8","8","0","0","3","0","0","4","0","12","29.10.12"
"350427","101","Кіровоградська область","ліцей переробної промисловості, спортивна зала
вул.Урицького, 2, смт Капітанівка, Новомиргородський р-н, Кіровоградська обл., 26010","1050","529","1036","45","488","33","521","","0","488","33","521","18","503","86","28","73","2","1","48","0","1","61","8","195","28.10.12"
"350428","101","Кіровоградська область","школа, хол
вул.Смілянська, 55, смт Капітанівка, Новомиргородський р-н, Кіровоградська обл., 26010","1008","614","999","30","367","27","394","","0","367","27","394","25","369","78","29","55","4","1","25","1","1","37","12","126","29.10.12"
"350429","101","Кіровоградська область","сільський клуб, зала
вул.Суворова, 1, с.Прищепівка, Новомиргородський р-н, Кіровоградська обл., 26010","276","113","279","9","155","8","163","","0","155","8","163","3","160","51","4","28","6","0","16","1","0","9","2","43","28.10.12"
"350430","101","Кіровоградська область","сільський будинок культури, фойє
вул.Центральна, 22, с.Веселівка, Новомиргородський р-н, Кіровоградська обл., 26042","198","58","197","15","125","15","140","","0","125","15","140","4","136","31","3","6","0","0","26","0","0","28","4","38","29.10.12"
"350431","101","Кіровоградська область","сільський клуб, зала
вул.Шевченка, 3, с.Дібрівка, Новомиргородський р-н, Кіровоградська обл., 26021","222","66","212","16","140","16","156","","0","140","16","156","6","150","31","6","14","3","2","26","0","1","25","7","35","28.10.12"
"350432","101","Кіровоградська область","ТОВ ""Агроконтракт-Н"", хол
вул.70-річчя Жовтня, 51, с.Бурти, Новомиргородський р-н, Кіровоградська обл., 26021","120","34","114","18","72","14","86","","0","72","14","86","2","84","11","3","3","0","1","5","0","0","16","2","43","28.10.12"
"350433","101","Кіровоградська область","ТОВ ""Прищепівка"", хол
вул.Шевченка, 34, с.Василівка, Новомиргородський р-н, Кіровоградська обл., 26021","60","16","60","8","36","8","44","","0","36","8","44","0","44","9","4","1","0","0","10","0","1","5","4","10","28.10.12"
"350434","101","Кіровоградська область","ветеринарна дільниця, хол
вул.Лісова, 9, с.Зелене, Новомиргородський р-н, Кіровоградська обл., 26021","84","37","79","3","44","3","47","","0","44","3","47","4","43","8","2","2","1","0","10","0","0","12","0","8","28.10.12"
"350435","101","Кіровоградська область","сільський будинок культури, глядацька зала
вул.70-річчя Жовтня, 26, с.Жовтневе, Новомиргородський р-н, Кіровоградська обл., 26016","246","95","246","18","134","17","151","","0","134","17","151","1","150","32","5","6","1","1","30","8","0","24","1","42","28.10.12"
"350436","101","Кіровоградська область","сільський будинок культури, зала
вул.Леніна, 86, с.Йосипівка, Новомиргородський р-н, Кіровоградська обл., 26030","444","148","440","52","249","47","296","","0","249","47","296","6","290","71","20","18","2","2","34","6","0","64","5","68","28.10.12"
"350437","101","Кіровоградська область","початкова школа, к.1
вул.Зелена, 3, с.Защита, Новомиргородський р-н, Кіровоградська обл., 26000","138","45","137","11","84","9","93","","0","84","9","93","3","90","16","1","12","0","0","9","1","0","17","12","22","10.11.12"
"350438","101","Кіровоградська область","сільський клуб, зала
вул.Гагаріна, 34А, с.Кам’януватка, Новомиргородський р-н, Кіровоградська обл., 26030","144","58","135","15","71","15","86","","0","71","15","86","4","82","14","6","7","0","1","10","1","1","13","2","27","28.10.12"
"350439","101","Кіровоградська область","сільський будинок культури, мала зала
вул.Карла Маркса, 74, с.Кам’янка, Новомиргородський р-н, Кіровоградська обл., 26032","510","189","502","54","274","47","321","","0","274","47","321","6","315","88","8","30","1","3","57","0","1","69","6","52","10.11.12"
"350440","101","Кіровоградська область","сільська рада, к.1
вул.Жовтнева, 24, с.Каніж, Новомиргородський р-н, Кіровоградська обл., 26035","696","258","692","81","367","71","438","","0","367","71","438","14","424","139","18","43","3","11","24","1","2","59","22","102","29.10.12"
"350441","101","Кіровоградська область","сільська рада, актова зала
вул.Леніна, 25, с.Коробчине, Новомиргородський р-н, Кіровоградська обл., 26014","714","332","692","48","339","43","382","","0","339","43","382","10","372","88","22","39","2","0","35","1","2","62","11","110","29.10.12"
"350442","101","Кіровоградська область","сільський клуб, зала
вул.Колгоспна, 50А, с.Костянтинівка, Новомиргородський р-н, Кіровоградська обл., 26000","654","260","645","82","321","73","394","","0","321","73","394","13","381","154","14","31","1","8","28","1","3","33","12","96","28.10.12"
"350443","101","Кіровоградська область","сільський будинок культури, велика зала
вул.Перемоги, 214, с.Листопадове, Новомиргородський р-н, Кіровоградська обл., 26012","876","370","862","48","463","43","506","","0","463","43","506","15","491","106","6","82","1","0","23","0","3","109","26","135","29.10.12"
"350444","101","Кіровоградська область","сільський будинок культури, велика зала
вул.Леніна, 17, с.Андріївка, Новомиргородський р-н, Кіровоградська обл., 26013","144","35","143","16","101","8","109","","0","101","8","109","1","108","19","6","10","0","0","15","0","0","12","5","41","28.10.12"
"350445","101","Кіровоградська область","сільська рада, хол
вул.Тараса Шевченка, 20, с.Мар’ївка, Новомиргородський р-н, Кіровоградська обл., 26041","168","39","161","12","117","12","129","","0","117","12","129","4","125","37","12","2","1","1","10","0","0","42","5","15","29.10.12"
"350446","101","Кіровоградська область","СТОВ ""Степове"", хол
вул.Миру, 74, с.Мартоноша, Новомиргородський р-н, Кіровоградська обл., 26033","732","261","718","74","403","68","471","","0","403","68","471","15","456","185","23","38","3","6","57","2","1","47","3","91","29.10.12"
"350447","101","Кіровоградська область","сільський клуб ""Правда"", зала
вул.Перемоги, 67, с.Мартоноша, Новомиргородський р-н, Кіровоградська обл., 26033","348","107","344","30","217","24","241","","0","217","24","241","7","234","46","12","19","1","0","87","0","2","28","2","37","29.10.12"
"350448","101","Кіровоградська область","сільський будинок культури, мала зала
вул.Леніна, 14, с.Оситняжка, Новомиргородський р-н, Кіровоградська обл., 26020","606","206","592","31","369","31","400","","0","369","31","400","18","382","140","4","52","1","8","26","1","2","23","12","113","29.10.12"
"350449","101","Кіровоградська область","сільська рада, кімната урочистих подій
вул.Жовтнева, 44, с.Оситна, Новомиргородський р-н, Кіровоградська обл., 26043","282","102","273","15","167","13","180","","0","167","13","180","7","173","40","6","17","1","1","19","0","1","45","9","34","29.10.12"
"350450","101","Кіровоградська область","сільська рада, зала засідань
вул.Жовтнева, 1, с.Панчеве, Новомиргородський р-н, Кіровоградська обл., 26034","1194","490","1184","57","647","57","704","","0","647","57","704","12","692","179","19","133","2","2","30","4","3","58","10","252","29.10.12"
"350451","101","Кіровоградська область","сільська рада, хол
вул.Леніна, 14, с.Петроострів, Новомиргородський р-н, Кіровоградська обл., 26015","426","176","408","76","181","69","250","","0","181","69","250","6","244","46","13","10","0","0","23","36","0","33","4","79","28.10.12"
"350452","101","Кіровоградська область","сільський будинок культури, фойє
вул.Леніна, 11А, с.Пурпурівка, Новомиргородський р-н, Кіровоградська обл., 26040","378","132","373","35","213","33","246","","0","213","33","246","3","243","60","28","16","0","3","11","0","0","66","13","46","29.10.12"
"350453","101","Кіровоградська область","ТОВ ""Укрзернопром-Новомиргород"", хол
вул.Леніна, 126, с.Рубаний Міст, Новомиргородський р-н, Кіровоградська обл., 26014","438","175","432","53","218","45","263","","0","218","45","263","12","251","38","9","32","2","3","35","3","1","68","12","48","28.10.12"
"350454","101","Кіровоградська область","сільський клуб, фойє
вул.Перемоги, 114, с.Тишківка, Новомиргородський р-н, Кіровоградська обл., 26031","714","336","703","58","330","48","378","","0","330","48","378","10","368","74","12","42","1","5","46","1","1","40","14","132","29.10.12"
"350455","101","Кіровоградська область","сільський будинок культури, зала
вул.Леніна, 123, с.Турія, Новомиргородський р-н, Кіровоградська обл., 26011","930","348","912","82","507","75","582","","0","507","75","582","11","571","204","17","68","1","2","27","4","1","52","22","173","29.10.12"
"350456","101","Кіровоградська область","сільський будинок культури, зала
вул.Леніна, 23, с.Шпакове, Новомиргородський р-н, Кіровоградська обл., 26022","186","55","183","14","118","13","131","","0","118","13","131","2","129","53","5","6","1","1","9","1","0","13","1","39","29.10.12"
"350457","101","Кіровоградська область","фельдшерсько-акушерський пункт, хол
вул.Шевченка, 10, с.Бровкове, Новомиргородський р-н, Кіровоградська обл., 26022","72","33","72","4","35","4","39","","0","35","4","39","0","39","15","3","1","0","1","3","0","0","9","0","7","28.10.12"
"350669","101","Кіровоградська область","школа, спортзал
вул.Леніна, 55, с.Богданове, Ульяновський р-н, Кіровоградська обл., 26432","378","129","373","22","227","22","249","","0","227","22","249","7","242","78","10","12","1","1","43","0","0","52","9","36","28.10.12"
"350670","101","Кіровоградська область","школа, спортзал
вул.Поворознюка, 10А, с.Великі Трояни, Ульяновський р-н, Кіровоградська обл., 26413","900","296","880","89","520","84","604","","0","520","84","604","18","586","140","13","92","5","4","37","2","3","76","44","170","28.10.12"
"350671","101","Кіровоградська область","школа, вестибюль
вул.Гагаріна, 5, с.Вільхове, Ульяновський р-н, Кіровоградська обл., 26410","852","382","837","79","402","68","470","","0","402","68","470","20","450","119","25","65","3","2","35","1","3","72","25","100","29.10.12"
"350672","101","Кіровоградська область","будинок культури, вестибюль
вул.Шевченка, 1Б, с.Грушка, Ульяновський р-н, Кіровоградська обл., 26420","1068","431","1053","61","579","58","637","","0","579","58","637","11","626","169","28","73","8","24","39","6","12","86","37","144","29.10.12"
"350673","101","Кіровоградська область","будинок культури, вестибюль
вул.Наумова, 160, с.Станіславове, Ульяновський р-н, Кіровоградська обл., 26421","84","19","79","12","53","12","65","","0","53","12","65","3","62","13","10","16","0","0","1","0","1","3","3","15","28.10.12"
"350674","101","Кіровоградська область","школа, вестибюль
вул.Леніна, 2, с.Данилова Балка, Ульяновський р-н, Кіровоградська обл., 26440","618","244","609","47","332","42","374","","0","332","42","374","12","362","96","28","36","0","2","45","0","0","96","6","53","29.10.12"
"350675","101","Кіровоградська область","будинок культури, вестибюль
вул.Шевченка, 41, с.Шевченка, Ульяновський р-н, Кіровоградська обл., 26440","150","37","147","24","89","24","113","","0","89","24","113","2","111","18","5","8","0","0","10","0","0","56","2","12","28.10.12"
"350676","101","Кіровоградська область","будинок культури, вестибюль
вул.Центральна, 19, с.Йосипівка, Ульяновський р-н, Кіровоградська обл., 26414","1146","466","1146","90","598","82","680","","0","598","82","680","16","664","143","17","40","1","11","129","3","5","86","50","179","29.10.12"
"350677","101","Кіровоградська область","будинок культури, фойє
вул.Орджонікідзе, 9, с.Кам’яний Брід, Ульяновський р-н, Кіровоградська обл., 26430","600","242","592","36","327","31","358","","0","327","31","358","13","345","118","6","47","2","3","48","1","1","52","23","44","28.10.12"
"350678","101","Кіровоградська область","сільський клуб, к.2
вул.Леніна, 3, с.Христофорове, Ульяновський р-н, Кіровоградська обл., 26431","144","52","142","14","83","9","92","","0","83","9","92","4","88","31","3","2","1","0","18","0","0","17","2","14","28.10.12"
"350679","101","Кіровоградська область","школа, спортзал
вул.Леніна, 130, с.Кам’яна Криниця, Ульяновський р-н, Кіровоградська обл., 26412","804","338","793","53","419","47","466","","0","419","47","466","18","448","105","12","46","5","0","21","1","2","143","34","79","28.10.12"
"350680","101","Кіровоградська область","будинок культури, вестибюль
вул.Фрунзе, 54, с.Лозувата, Ульяновський р-н, Кіровоградська обл., 26441","888","351","872","56","485","52","537","","0","485","52","537","27","510","98","18","47","4","0","115","12","0","67","28","121","29.10.12"
"350681","101","Кіровоградська область","будинок культури, вестибюль
вул.Змійововго, 39, с.Дельфінове, Ульяновський р-н, Кіровоградська обл., 26442","252","72","249","33","148","32","180","","0","148","32","180","5","175","65","16","11","1","0","44","1","0","22","1","14","29.10.12"
"350682","101","Кіровоградська область","будинок культури, фойє
вул.Колгоспна, 116, с.Луполове, Ульяновський р-н, Кіровоградська обл., 26443","456","218","452","28","212","26","238","","0","212","26","238","7","231","34","9","37","2","0","24","1","1","83","8","32","29.10.12"
"350683","101","Кіровоградська область","будинок культури, фойє
вул.Кооперативна, 42, с.Кошаро-Олександрівка, Ульяновський р-н, Кіровоградська обл., 26444","204","88","201","18","98","18","116","","0","98","18","116","4","112","28","4","20","2","2","20","1","0","15","4","16","29.10.12"
"350684","101","Кіровоградська область","будинок культури, вестибюль
вул.Центральна, 3, с.Мечиславка, Ульяновський р-н, Кіровоградська обл., 26415","558","240","546","45","277","41","318","","0","277","41","318","17","301","84","9","28","2","0","39","1","0","62","16","60","28.10.12"
"350685","101","Кіровоградська область","школа, фойє
вул.Леніна, 70, с.Новоселиця, Ульяновський р-н, Кіровоградська обл., 26423","1062","383","1058","72","612","67","679","","0","612","67","679","13","666","171","34","72","6","30","68","4","4","68","25","184","29.10.12"
"350686","101","Кіровоградська область","школа, вестибюль
вул.Леніна, 50А, с.Розношенське, Ульяновський р-н, Кіровоградська обл., 26422","672","222","663","72","383","67","450","","0","383","67","450","9","441","189","9","50","1","4","30","3","6","48","37","64","29.10.12"
"350687","101","Кіровоградська область","школа, їдальня
вул.Леніна, 159, с.Сабатинівка, Ульяновський р-н, Кіровоградська обл., 26434","732","358","721","64","330","44","374","","0","330","44","374","11","363","97","15","27","2","0","21","2","1","99","11","88","29.10.12"
"350688","101","Кіровоградська область","будинок культури, вестибюль
вул.Леніна, 35, с.Синицівка, Ульяновський р-н, Кіровоградська обл., 26433","294","96","287","26","179","19","198","","0","179","19","198","7","191","130","6","13","2","2","10","0","0","14","1","13","29.10.12"
"350689","101","Кіровоградська область","будинок культури, обрядова кімната
вул.Леніна, 23, с.Синьки, Ульяновський р-н, Кіровоградська обл., 26411","774","306","760","79","406","62","468","","0","406","62","468","12","456","102","23","31","5","5","50","9","52","111","12","56","08.11.12"
"350690","101","Кіровоградська область","будинок культури, вестибюль
вул.Леніна, 68, м.Ульяновка, Ульяновський р-н, Кіровоградська обл., 26400","1920","912","1906","70","972","36","1008","","0","972","36","1008","13","995","136","67","128","7","8","68","7","10","240","75","249","29.10.12"
"350691","101","Кіровоградська область","відділ реєстрації актів цивільного стану управління юстиції, обрядова зала
вул.Промислова, 23/54, м.Ульяновка, Ульяновський р-н, Кіровоградська обл., 26400","1644","807","1574","32","805","32","837","","0","805","32","837","24","813","129","42","109","4","4","72","4","2","171","105","171","29.10.12"
"350692","101","Кіровоградська область","гімназія, школа №1, їдальня
пров.Леніна, 7, м.Ульяновка, Ульяновський р-н, Кіровоградська обл., 26400","1974","863","2013","92","1039","72","1111","","0","1039","72","1111","40","1071","164","51","147","5","7","49","4","6","178","131","329","28.10.12"
"350693","101","Кіровоградська область","школа, спортзал
вул.Чернишевського, 6, с.Шамраєве, Ульяновський р-н, Кіровоградська обл., 26452","1356","549","1358","86","744","63","807","","0","744","63","807","12","795","227","11","54","0","21","36","3","0","232","57","154","29.10.12"
