"№ ВД","OBO","Назва регіону України","Місцезнаходження та адреса приміщення для голосування","1) К-сть одержаних бюлетенів","2) К-сть невикористаних бюлетенів","3) К-сть виборців, внесених до списку виборців","4) К-сть виборців, внесених до витягу зі списку виборців","5) К-сть виборців, які отримали бюлетені у приміщенні","6) К-сть виборців, які отримали за місцем перебування","7) Сумарна к-сть виборців, які отримали бюлетені","8) К-сть бюлетенів, що виявилися у кожній скринці","9) К-сть бюлетенів, що не підлягають врахуванню","10) К-сть виборців, які взяли участь у голос. у приміщенні для гол.","11) К-сть виборців, які взяли участь у голос. за місцем перебування","12) К-сть виборців, які взяли участь у голосуванні на виборчій дільниці","13) К-сть бюлетенів, визнаних недійсними","14) Сумарна к-сть голосів виборців ЗА","Алексєєв
Володимир
Васильович","Жаботинський
Андрій
Вікторович","Задорожний
Вячеслав
Казимирович","Кривенко
Ірина
Василівна","Дата підписання протоколу"
"121482","33","Дніпропетровська область","Криворізький педагогічний інститут (гуманітарний корпус), вестибюль, 1-й поверх
вул.Димитрова, 79А, м.Кривий Ріг, Дніпропетровська обл., 50027","2344","937","2303","30","1383","24","1407","","0","1383","24","1407","78","1329","298","285","494","252","29.10.12"
"121483","33","Дніпропетровська область","школа №7, коридор, 1-й поверх
вул.Димитрова, 48, м.Кривий Ріг, Дніпропетровська обл., 50027","1512","719","1497","29","775","18","793","","0","775","18","793","31","762","155","139","319","149","29.10.12"
"121484","33","Дніпропетровська область","музична школа №4, лівий хол, 1-й поверх
вул.22 Партз’їзду, 32А, м.Кривий Ріг, Дніпропетровська обл., 50065","1664","743","1649","22","902","19","921","","0","902","19","921","40","881","152","139","402","188","29.10.12"
"121485","33","Дніпропетровська область","музична школа №4, центральний хол, 1-й поверх
вул.22 Партз’їзду, 32А, м.Кривий Ріг, Дніпропетровська обл., 50065","1640","727","1623","21","897","16","913","","0","897","16","913","63","850","159","157","381","153","29.10.12"
"121486","33","Дніпропетровська область","школа №103, шкільна рекреація, 1-й поверх
вул.Костенка, 23, м.Кривий Ріг, Дніпропетровська обл., 50065","1968","874","1939","50","1063","31","1094","","0","1063","31","1094","60","1034","158","238","442","196","29.10.12"
"121487","33","Дніпропетровська область","Криворізький національний університет, корпус 1, фойє, 1-й поверх
вул.22 Партз’їзду, 11, м.Кривий Ріг, Дніпропетровська обл., 50027","2280","869","2274","50","1370","41","1411","","0","1370","41","1411","62","1349","261","316","544","228","29.10.12"
"121488","33","Дніпропетровська область","школа №4, шкільна рекреація, 1-й поверх
вул.Димитрова, 15, м.Кривий Ріг, Дніпропетровська обл., 50027","1376","588","1366","26","764","24","788","","0","764","24","788","34","754","144","142","304","164","29.10.12"
"121489","33","Дніпропетровська область","школа №26, хол, 2-й поверх
вул.Якіра, 7А, м.Кривий Ріг, Дніпропетровська обл., 50074","2170","952","2142","22","1203","15","1218","","0","1203","15","1218","53","1165","221","277","436","231","29.10.12"
"121490","33","Дніпропетровська область","школа №26, хол, 1-й поверх
вул.Якіра, 7А, м.Кривий Ріг, Дніпропетровська обл., 50074","2136","907","2125","51","1192","37","1229","","1","1191","37","1228","55","1173","231","247","507","188","29.10.12"
"121491","33","Дніпропетровська область","школа №26, вестибюль, 1-й поверх
вул.Якіра, 7А, м.Кривий Ріг, Дніпропетровська обл., 50074","1736","788","1713","32","920","28","948","","0","919","28","947","47","900","174","182","375","169","30.10.12"
"121492","33","Дніпропетровська область","школа №63, шкільна рекреація, 2-й поверх
вул.Агафонова, 14А, м.Кривий Ріг, Дніпропетровська обл., 50007","2336","1148","2306","45","1155","33","1188","","0","1155","33","1188","63","1125","201","274","451","199","29.10.12"
"121493","33","Дніпропетровська область","Криворізький національний університет, корпус 6 (будівельний факультет), фойє, 1-й поверх
вул.22 Партз’їзду, 13, м.Кривий Ріг, Дніпропетровська обл., 50027","2112","951","2079","26","1138","23","1161","","0","1138","23","1161","46","1115","217","249","470","179","29.10.12"
"121494","33","Дніпропетровська область","школа №69, спортивний зал, 1-й поверх
вул.Хабаровська, 4, м.Кривий Ріг, Дніпропетровська обл., 50050","1984","792","1965","35","1165","27","1192","","0","1165","27","1192","72","1120","197","287","431","205","29.10.12"
"121495","33","Дніпропетровська область","Палац культури металургів, хол, 1-й поверх
просп.Металургів, 7, м.Кривий Ріг, Дніпропетровська обл., 50050","1824","864","1814","23","943","17","960","","0","943","17","960","47","913","157","219","382","155","29.10.12"
"121496","33","Дніпропетровська область","гімназія №95, лівий вестибюль, 1-й поверх
вул.Косіора, 20, м.Кривий Ріг, Дніпропетровська обл., 50006","1448","630","1441","39","788","30","818","","0","788","30","818","39","779","134","168","342","135","29.10.12"
"121497","33","Дніпропетровська область","гімназія №95, правий вестибюль, 1-й поверх
вул.Косіора, 20, м.Кривий Ріг, Дніпропетровська обл., 50006","1328","534","1304","28","771","23","794","","0","771","23","794","34","760","170","168","293","129","29.10.12"
"121498","33","Дніпропетровська область","Криворізький науково-технічний металургійний ліцей №16, коридор (праве крило), 1-й поверх
вул.Революційна, 22, м.Кривий Ріг, Дніпропетровська обл., 50075","1504","704","1504","29","779","21","800","","0","779","21","800","49","751","132","136","306","177","29.10.12"
"121499","33","Дніпропетровська область","Криворізький науково-технічний металургійний ліцей №16, коридор (ліве крило), 1-й поверх
вул.Революційна, 22, м.Кривий Ріг, Дніпропетровська обл., 50075","1504","737","1491","18","754","13","767","","0","754","13","767","41","726","112","156","330","128","29.10.12"
"121500","33","Дніпропетровська область","Криворізький коксохімічний технікум, фойє, 1-й поверх
вул.Революційна, 40, м.Кривий Ріг, Дніпропетровська обл., 50103","2416","1236","2395","38","1152","28","1180","","0","1152","28","1180","61","1119","210","203","518","188","29.10.12"
"121501","33","Дніпропетровська область","Криворізький центр професійної освіти металургії та машинобудування, хол, 1-й поверх
пл.Домнобудівників, 10, м.Кривий Ріг, Дніпропетровська обл., 50103","2424","1490","2404","6","931","3","934","","0","931","3","934","60","874","177","126","396","175","29.10.12"
"121502","33","Дніпропетровська область","школа №18, спортивний зал, 1-й поверх
вул.Шиферна, 35, м.Кривий Ріг, Дніпропетровська обл., 50041","936","304","950","54","580","52","632","","0","580","52","632","46","586","63","64","395","64","28.10.12"
"121503","33","Дніпропетровська область","Навчально-курсовий комбінат ""Кривбасбуд"", вестибюль, 1-й поверх
вул.Вітчизни, 9, м.Кривий Ріг, Дніпропетровська обл., 50051","1680","786","1678","23","877","17","894","","0","877","17","894","44","850","146","130","413","161","29.10.12"
"121504","33","Дніпропетровська область","школа №66, спортивний зал, 1-й поверх
вул.Вокзальна, 6, м.Кривий Ріг, Дніпропетровська обл., 50051","2416","1203","2398","50","1174","39","1213","","0","1174","39","1213","73","1140","188","219","499","234","29.10.12"
"121505","33","Дніпропетровська область","школа №15, коридор, 2-й поверх
вул.Орджонікідзе, 40, м.Кривий Ріг, Дніпропетровська обл., 50005","2392","1121","2367","56","1227","44","1271","","0","1227","44","1271","54","1217","194","227","555","241","29.10.12"
"121506","33","Дніпропетровська область","Центр підготовки та перепідготовки робітничих кадрів №1, спортивний зал, 1-й поверх
вул.Каховська, 13, м.Кривий Ріг, Дніпропетровська обл., 50005","1784","847","1762","45","897","40","937","","0","897","40","937","53","884","159","195","386","144","29.10.12"
"121507","33","Дніпропетровська область","Криворізький національний університет, корпус 5 (металургійний факультет), фойє, 2-й поверх
вул.Островського, 21, м.Кривий Ріг, Дніпропетровська обл., 50005","2000","1039","1996","51","920","41","961","","0","920","41","961","61","900","140","138","407","215","29.10.12"
"121508","33","Дніпропетровська область","міська лікарня №1, хол денного стаціонару, 1-й поверх
вул.Рязанова, 8А, м.Кривий Ріг, Дніпропетровська обл., 50074","232","1","232","52","179","52","231","","0","179","52","231","7","224","16","19","174","15","28.10.12"
"121509","33","Дніпропетровська область","Криворізька інфекційна лікарня №1, вестибюль, 1-й поверх
вул.Олейникова, 5, м.Кривий Ріг, Днепропетровська обл., 50050","56","4","52","6","46","6","52","","0","46","6","52","0","52","1","2","49","0","28.10.12"
"121510","33","Дніпропетровська область","Криворізький протитуберкульозний диспансер №2, хол, 3-й поверх
вул.Олейникова, 4А, м.Кривий Ріг, Дніпропетровська обл., 50050","192","77","116","12","103","12","115","","0","103","12","115","4","111","15","7","77","12","28.10.12"
"121511","33","Дніпропетровська область","Криворізька виправна колонія №80, клуб, 1-й поверх
вул.Шиферна, 3, м.Кривий Ріг, Дніпропетровська обл., 50041","1496","11","1493","0","1485","0","1485","","0","1485","0","1485","62","1423","74","60","1225","64","28.10.12"
"121611","33","Дніпропетровська область","школа №67, коридор, 1-й поверх
вул.Переяславська, 6, м.Кривий Ріг, Дніпропетровська обл., 50022","2120","939","2071","49","1135","46","1181","","0","1135","46","1181","45","1136","132","126","667","211","29.10.12"
"121612","33","Дніпропетровська область","Політехнічний коледж КНУ, фойє, 1-й поверх
вул.Кармелюка, 33, м.Кривий Ріг, Дніпропетровська обл., 50026","1928","798","1927","36","1103","27","1130","","0","1103","27","1130","56","1074","118","173","594","189","29.10.12"
"121613","33","Дніпропетровська область","гуртожиток, к.59, 1-й поверх
вул.Кармелюка, 3, м.Кривий Ріг, Дніпропетровська обл., 50026","1728","645","1693","33","1055","28","1083","","0","1055","28","1083","46","1037","104","130","580","223","29.10.12"
"121614","33","Дніпропетровська область","Палац культури ВАТ""ПівдГЗК"", к.54, 2-й поверх
пл.60-річчя СРСР, 2, м.Кривий Ріг, Дніпропетровська обл., 50026","1760","628","1735","33","1104","28","1132","","0","1104","28","1132","31","1101","135","154","625","187","29.10.12"
"121615","33","Дніпропетровська область","Палац культури ВАТ""ПівдГЗК"", ігрова кімната, 1-й поверх
пл.60-річчя СРСР, 2, м.Кривий Ріг, Дніпропетровська обл., 50026","1736","648","1712","52","1043","45","1088","","0","1043","45","1088","22","1066","108","135","645","178","29.10.12"
"121616","33","Дніпропетровська область","школа №73, коридор, 1-й поверх
вул.Добролюбова, 7, м.Кривий Ріг, Дніпропетровська обл., 50026","1728","832","1714","53","855","41","896","","0","855","41","896","52","844","84","108","445","207","29.10.12"
"121617","33","Дніпропетровська область","школа №92, коридор, 1-й поверх
вул.Таганська, 1, м.Кривий Ріг, Дніпропетровська обл., 50026","1936","861","1903","56","1033","42","1075","","0","1033","42","1075","59","1016","111","141","534","230","29.10.12"
"121618","33","Дніпропетровська область","Дитячо-юнацька спортивна школа №2, спортивна зала, 1-й поверх
вул.Груні Романової, 21А, м.Кривий Ріг, Дніпропетровська обл., 50026","1944","897","1915","26","1029","18","1047","","0","1029","18","1047","55","992","117","115","556","204","29.10.12"
"121619","33","Дніпропетровська область","школа №82, коридор, 1-й поверх
вул.Кронштадтська, 20, м.Кривий Ріг, Дніпропетровська обл., 50026","2200","1131","2177","76","1021","48","1069","","0","1021","48","1069","67","1002","146","127","516","213","29.10.12"
"121636","33","Дніпропетровська область","Криворізька міська лікарня №11, адмінбудинок, коридор, 1-й поверх
вул.Добролюбова, 6, м.Кривий Ріг, Дніпропетровська обл., 50026","184","0","197","33","153","31","184","","0","153","31","184","17","167","31","21","84","31","29.10.12"
"121684","33","Дніпропетровська область","Науково-дослідний гірничорудний інститут, к.118, 1-й поверх
вул.Галенка, 2, м.Кривий Ріг, Дніпропетровська обл., 50086","2136","953","2109","56","1137","46","1183","","0","1137","46","1183","74","1109","184","268","420","237","29.10.12"
"121685","33","Дніпропетровська область","школа №70, к.3, 1-й поверх
вул.Отто Брозовського, 79, м.Кривий Ріг, Дніпропетровська обл., 50027","2232","982","2195","63","1195","55","1250","","0","1195","55","1250","48","1202","242","301","455","204","29.10.12"
"121686","33","Дніпропетровська область","школа №70, к.5, 1-й поверх
вул.Отто Брозовського, 79, м.Кривий Ріг, Дніпропетровська обл., 50027","2152","961","2105","60","1143","48","1191","","0","1143","48","1191","58","1133","221","271","448","193","29.10.12"
"121687","33","Дніпропетровська область","музична школа №3, к.1, 1-й поверх
вул.Демиденка, 11, м.Кривий Ріг, Дніпропетровська обл., 50007","1672","664","1634","19","993","15","1008","","0","992","15","1007","45","962","203","242","360","157","29.10.12"
"121688","33","Дніпропетровська область","центр професійної освіти металургії та машинобудування, к.1, 1-й поверх
просп.Дзержинського, 7, м.Кривий Ріг, Дніпропетровська обл., 50007","1728","763","1698","44","933","32","965","","0","933","32","965","36","929","171","232","348","178","29.10.12"
"121689","33","Дніпропетровська область","школа №17, к.22, 2-й поверх
просп.Дзержинського, 36А, м.Кривий Ріг, Дніпропетровська обл., 50007","1760","715","1735","39","1011","34","1045","","0","1011","34","1045","45","1000","193","255","394","158","29.10.12"
"121734","33","Дніпропетровська область","школа №104, вестибюль, 1-й поверх
вул.Авангардна, 8, с-ще Авангард, м.Кривий Ріг, Дніпропетровська обл., 50482","1208","520","1186","18","672","16","688","","0","672","16","688","31","657","72","63","430","92","29.10.12"
"121735","33","Дніпропетровська область","бібліотека УТОС, 1-й поверх
вул.Українська, 290, м.Кривий Ріг, Дніпропетровська обл., 50072","1152","648","1135","28","480","24","504","","0","480","24","504","29","475","98","77","218","82","29.10.12"
"121736","33","Дніпропетровська область","школа №2, актова зала, 1-й поверх
вул.Шмідта, 76А, м.Кривий Ріг, Дніпропетровська обл., 50072","1808","1106","1777","23","682","20","702","","0","682","20","702","37","665","118","132","267","148","29.10.12"
"121737","33","Дніпропетровська область","школа №2, їдальня, 1-й поверх
вул.Шмідта, 76А, м.Кривий Ріг, Дніпропетровська обл., 50072","1936","1054","1914","27","857","25","882","","0","857","25","882","44","838","190","170","330","148","29.10.12"
"121738","33","Дніпропетровська область","школа №28, спортивний зал, 1-й поверх
вул.Українська, 202В, м.Кривий Ріг, Дніпропетровська обл., 50072","1840","832","1822","57","952","56","1008","","0","952","56","1008","48","960","206","212","399","143","29.10.12"
"121739","33","Дніпропетровська область","Авіаколедж, хол, 1-й поверх
вул.Туполєва, 1, м.Кривий Ріг, Дніпропетровська обл., 50045","2200","1155","2148","36","1011","34","1045","","0","1011","34","1045","46","999","189","185","447","178","29.10.12"
"121740","33","Дніпропетровська область","Авіаколедж, актова зала, 1-й поверх
вул.Туполєва, 1, м.Кривий Ріг, Дніпропетровська обл., 50045","1632","681","1642","48","909","42","951","","0","909","42","951","39","912","181","154","455","122","29.10.12"
"121741","33","Дніпропетровська область","школа №60, спортивний зал, 1-й поверх
вул.Українська, 66, м.Кривий Ріг, Дніпропетровська обл., 50024","2152","1149","2127","21","985","18","1003","","0","985","18","1003","41","962","203","221","377","161","29.10.12"
"121742","33","Дніпропетровська область","школа №60, їдальня, 1-й поверх
вул.Українська, 66, м.Кривий Ріг, Дніпропетровська обл., 50024","1984","859","1949","17","1113","12","1125","","0","1113","12","1125","45","1080","223","233","468","156","29.10.12"
"121743","33","Дніпропетровська область","Інститут ""НДПІрудмаш"", каб.112, 1-й поверх
вул.Харитонова, 1А, м.Кривий Ріг, Дніпропетровська обл., 50024","1992","865","1946","13","1116","11","1127","","0","1116","11","1127","54","1073","204","225","476","168","29.10.12"
"121744","33","Дніпропетровська область","Інститут ""НДПІрудмаш"", актова зала, 1-й поверх
вул.Харитонова, 1А, м.Кривий Ріг, Дніпропетровська обл., 50024","1960","771","1930","22","1170","19","1189","","0","1170","19","1189","58","1131","246","264","441","180","29.10.12"
"121745","33","Дніпропетровська область","школа №5, актова зала, 1-й поверх
вул.Правди, 28, м.Кривий Ріг, Дніпропетровська обл., 50019","2328","1244","2294","14","1071","13","1084","","1","1071","12","1083","47","1036","191","171","515","159","29.10.12"
"121746","33","Дніпропетровська область","школа №12, їдальня, 1-й поверх
вул.Погребняка, 3, м.Кривий Ріг, Дніпропетровська обл., 50025","1888","838","1848","13","1038","12","1050","","0","1038","12","1050","60","990","165","196","416","213","28.10.12"
"121747","33","Дніпропетровська область","МЦППВ, вестибюль, 1-й поверх
вул.Ушакова, 4, м.Кривий Ріг, Дніпропетровська обл., 50025","1808","872","1796","31","909","27","936","","0","909","27","936","52","884","146","170","341","227","29.10.12"
"121748","33","Дніпропетровська область","школа №79, актова зала, 1-й поверх
вул.Політехнічна, 77, м.Кривий Ріг, Дніпропетровська обл., 50025","2048","962","2022","6","1081","5","1086","","0","1081","5","1086","58","1028","226","182","421","199","29.10.12"
"121749","33","Дніпропетровська область","школа №23, їдальня, 1-й поверх
вул.Політехнічна, 71А, м.Кривий Ріг, Дніпропетровська обл., 50025","2104","975","2076","27","1105","24","1129","","0","1105","24","1129","41","1088","230","201","467","190","29.10.12"
"121750","33","Дніпропетровська область","школа №23, вестибюль, 1-й поверх
вул.Політехнічна, 71А, м.Кривий Ріг, Дніпропетровська обл., 50025","2168","971","2148","28","1170","27","1197","","0","1170","27","1197","69","1128","228","221","450","229","29.10.12"
"121751","33","Дніпропетровська область","школа №123, хол, 1-й поверх
вул.Миколаївське шосе, 18, м.Кривий Ріг, Дніпропетровська обл., 50067","2264","1088","2227","2","1175","1","1176","","0","1175","1","1176","55","1121","215","184","525","197","29.10.12"
"121752","33","Дніпропетровська область","школа №123, хол, 1-й поверх
вул.Миколаївське шосе, 18, м.Кривий Ріг, Дніпропетровська обл., 50067","2256","1143","2224","13","1101","12","1113","","1","1101","12","1113","50","1063","172","200","456","235","29.10.12"
"121753","33","Дніпропетровська область","школа №39, спортивний зал, 1-й поверх
вул.Яцьківа, 41А, м.Кривий Ріг, Дніпропетровська обл., 50032","920","480","900","35","409","31","440","","0","409","31","440","21","419","37","39","273","70","29.10.12"
"121754","33","Дніпропетровська область","школа №64, коридор, 1-й поверх
вул.Зорге, 1, м.Кривий Ріг, Дніпропетровська обл., 50097","840","411","818","40","391","38","429","","0","391","38","429","19","410","43","45","225","97","28.10.12"
"121755","33","Дніпропетровська область","адмінбудівля радгоспу ""Степовий"", їдальня, 1-й поверх
вул.Меріме, 50, м.Кривий Ріг, Дніпропетровська обл., 50097","400","177","401","23","200","23","223","","0","200","23","223","9","214","24","7","101","82","29.10.12"
"121756","33","Дніпропетровська область","школа №85, вестибюль, 1-й поверх
мікрорайон Всебратське-2, 65Б, м.Кривий Ріг, Дніпропетровська обл., 50046","2200","1020","2177","9","1171","9","1180","","0","1171","9","1180","51","1129","161","151","638","179","29.10.12"
"121757","33","Дніпропетровська область","школа №85, вестибюль, 1-й поверх
мікрорайон Всебратське-2, 65Б, м.Кривий Ріг, Дніпропетровська обл., 50046","2192","976","2143","6","1213","3","1216","","0","1212","3","1215","48","1167","235","185","557","190","30.10.12"
"121758","33","Дніпропетровська область","Будинок офіцерів, вестибюль, 1-й поверх
Військове містечко-35, Будинок офіцерів, м.Кривий Ріг, Дніпропетровська обл., 50046","2032","1054","2011","14","965","13","978","","0","965","13","978","50","928","170","115","478","165","29.10.12"
"121759","33","Дніпропетровська область","школа №29, актова зала, 1-й поверх
вул.Рахманінова, 1, м.Кривий Ріг, Дніпропетровська обл., 50001","2272","1141","2248","61","1071","60","1131","","0","1071","60","1131","41","1090","153","177","498","262","29.10.12"
"121760","33","Дніпропетровська область","школа №30, хол, 1-й поверх
вул.Кленова, 9, м.Кривий Ріг, Дніпропетровська обл., 50004","1864","1057","1843","16","794","13","807","","0","794","13","807","48","759","136","118","338","167","29.10.12"
"121761","33","Дніпропетровська область","школа №10, спортивний зал, 1-й поверх
вул.Єгорова, 6, м.Кривий Ріг, Дніпропетровська обл., 50004","2096","985","2056","38","1080","31","1111","","0","1080","31","1111","67","1044","173","212","439","220","29.10.12"
"121762","33","Дніпропетровська область","МЦППВ, їдальня, 1-й поверх
вул.Комуністична, 13, м.Кривий Ріг, Дніпропетровська обл., 50004","1592","630","1568","23","942","20","962","","0","942","20","962","42","920","157","179","393","191","29.10.12"
"121763","33","Дніпропетровська область","школа №13, їдальня, 1-й поверх
вул.Шкільна, 27Ж, м.Кривий Ріг, Дніпропетровська обл., 50098","1464","764","1461","24","679","21","700","","0","679","21","700","37","663","116","106","340","101","29.10.12"
"121764","33","Дніпропетровська область","школа №13, спортивний зал, 1-й поверх
вул.Шкільна, 27Ж, м.Кривий Ріг, Дніпропетровська обл., 50098","1336","713","1327","27","598","25","623","","0","598","25","623","45","578","80","85","294","119","29.10.12"
"121765","33","Дніпропетровська область","школа №8, коридор, 1-й поверх
вул.Першотравнева, 16А, м.Кривий Ріг, Дніпропетровська обл., 50000","1824","775","1814","19","1033","16","1049","","0","1033","16","1049","39","1010","182","241","430","157","29.10.12"
"121766","33","Дніпропетровська область","Інститут ""НДІБПГ"", ауд.302А, 3-й поверх
вул.Першотравнева, 12, м.Кривий Ріг, Дніпропетровська обл., 50000","2040","885","2008","20","1137","18","1155","","0","1137","18","1155","54","1101","200","237","490","174","29.10.12"
"121767","33","Дніпропетровська область","гімназія, вестибюль, 1-й поверх
вул.Першотравнева, 16, м.Кривий Ріг, Дніпропетровська обл., 50000","1856","783","1841","34","1041","32","1073","","0","1041","32","1073","40","1033","197","220","449","167","29.10.12"
"121768","33","Дніпропетровська область","школа №20, коридор, 1-й поверх
вул.Жовтнева, 31, м.Кривий Ріг, Дніпропетровська обл., 50000","1760","826","1751","26","909","25","934","","0","909","25","934","48","886","164","227","348","147","29.10.12"
"121769","33","Дніпропетровська область","Інститут ""Кривбаспроект"", зал для конференцій, 1-й поверх
просп.Карла Маркса, 40, м.Кривий Ріг, Дніпропетровська обл., 50000","1448","631","1435","13","807","10","817","","3","804","10","814","27","787","157","163","353","114","29.10.12"
"121770","33","Дніпропетровська область","ліцей, актова зала, 1-й поверх
вул.Лермонтова, 12, м.Кривий Ріг, Дніпропетровська обл., 50002","1568","648","1549","40","881","39","920","","0","881","39","920","48","872","126","205","380","161","29.10.12"
"121771","33","Дніпропетровська область","школа №1, вестибюль, 1-й поверх
вул.Чкалова, 1, м.Кривий Ріг, Дніпропетровська обл., 50000","1592","887","1563","8","700","5","705","","0","700","5","705","19","686","115","152","279","140","28.10.12"
"121772","33","Дніпропетровська область","Центр ""Зміна"", фойє, 1-й поверх
вул.Пушкіна, 8, м.Кривий Ріг, Дніпропетровська обл., 50002","1968","949","1946","21","1002","17","1019","","0","1002","17","1019","47","972","205","201","411","155","29.10.12"
"121773","33","Дніпропетровська область","Криворізький економічний інститут, хол, 1-й поверх
просп.Карла Маркса, 64, м.Кривий Ріг, Дніпропетровська обл., 50000","1624","622","1612","21","987","15","1002","","0","986","15","1001","30","971","211","211","370","179","29.10.12"
"121774","33","Дніпропетровська область","Український політехнічний технікум, хол, 1-й поверх
просп.Карла Маркса, 66, м.Кривий Ріг, Дніпропетровська обл., 50000","1880","826","1868","18","1037","17","1054","","0","1037","17","1054","37","1017","240","240","365","172","29.10.12"
"121775","33","Дніпропетровська область","Криворізький міський клінічний пологовий будинок №1, вестибюль, 1-й поверх
пл.Визволення, 11, м.Кривий Ріг, Дніпропетровська обл., 50000","160","48","112","0","112","0","112","","0","112","0","112","7","105","8","6","86","5","28.10.12"
"121776","33","Дніпропетровська область","Криворізька міська лікарня №3, хол, 1-й поверх
вул.Пушкіна, 13, м.Кривий Ріг, Дніпропетровська обл., 50002","296","65","232","0","231","0","231","","0","231","0","231","19","212","31","27","115","39","29.10.12"
