"№ ВД","OBO","Назва регіону України","Місцезнаходження та адреса приміщення для голосування","1) К-сть одержаних бюлетенів","2) К-сть невикористаних бюлетенів","3) К-сть виборців, внесених до списку виборців","4) К-сть виборців, внесених до витягу зі списку виборців","5) К-сть виборців, які отримали бюлетені у приміщенні","6) К-сть виборців, які отримали за місцем перебування","7) Сумарна к-сть виборців, які отримали бюлетені","8) К-сть бюлетенів, що виявилися у кожній скринці","9) К-сть бюлетенів, що не підлягають врахуванню","10) К-сть виборців, які взяли участь у голос. у приміщенні для гол.","11) К-сть виборців, які взяли участь у голос. за місцем перебування","12) К-сть виборців, які взяли участь у голосуванні на виборчій дільниці","13) К-сть бюлетенів, визнаних недійсними","14) Сумарна к-сть голосів виборців ЗА","Андріанов
Ігор
Юрійович","Бабіч
Олег
Іванович","Боделан
Володимир
Русланович","Болозович
Ярослав
Олегович","Георгієв
Іван
Васильович","Дубенко
Георгій
Миколайович","Загорюк
Сергій
Севастьянович","Келіогло
Василь
Григорійович","Крук
Юрій
Борисович","Онос
Юрій
Васильович","Пастух
Ігор
Миколайович","Руссу
Роман
Степанович","Страшилін
В’ячеслав
Михайлович","Чепой
Іван
Григорійович","Дата підписання протоколу"
"000001","143","Одеська область","
пр.Суворова, 70, м.Ізмаїл, Одеська обл., 68600","534","14","528","0","520","0","520","","0","520","0","520","78","442","18","26","59","27","13","14","12","35","184","16","8","4","15","11","28.10.12"
"000002","143","Одеська область","
""Вена""","0","4","15","0","12","0","12","","0","12","0","12","0","12","0","1","1","0","0","0","1","0","6","3","0","0","0","0","28.10.12"
"000003","143","Одеська область","
""Поти""","0","2","10","0","9","0","9","","0","9","0","9","0","9","0","0","0","0","0","0","0","1","0","4","0","0","4","0","28.10.12"
"000004","143","Одеська область","
""Дніпро""","0","0","55","0","55","0","55","","0","0","0","0","0","0","0","0","0","0","0","0","0","0","0","0","0","0","0","0","30.10.12"
"000005","143","Одеська область","
""Механик Сушков""","0","1","8","0","8","0","8","","0","8","0","8","0","8","1","1","1","0","0","1","0","1","0","0","2","0","0","1","28.10.12"
"000008","143","Одеська область","
""Рыбинск"" ","0","0","14","0","14","0","14","","0","0","0","0","0","0","0","0","0","0","0","0","0","0","0","0","0","0","0","0","28.10.12"
"000009","143","Одеська область","
""Знаменка""","0","1","12","0","12","0","12","","0","12","0","12","0","12","0","1","0","0","2","0","0","8","0","1","0","0","0","0","28.10.12"
"000010","143","Одеська область","
""Оренбург""","0","1","12","0","12","0","12","","0","12","0","12","0","12","1","5","0","0","1","0","0","0","2","0","1","0","0","2","28.10.12"
"000011","143","Одеська область","
""Григорий Морозов""","0","2","8","0","7","0","7","","0","7","0","7","2","5","0","0","0","0","0","1","0","0","0","0","4","0","0","0","28.10.12"
"000012","143","Одеська область","
""Львов""","0","0","13","0","13","0","13","","0","0","0","0","0","0","0","0","0","0","0","0","0","0","0","0","0","0","0","0","28.10.12"
"000013","143","Одеська область","
""Валентин Пиляев""","0","3","12","0","10","0","10","","0","10","0","10","0","10","1","7","1","1","0","0","0","0","0","0","0","0","0","0","28.10.12"
"000014","143","Одеська область","
""Зеленодольск""","0","3","12","0","10","0","10","","0","10","0","10","0","10","0","3","0","0","0","3","1","0","1","0","0","0","0","2","28.10.12"
"000015","143","Одеська область","
""Иркутск""","0","0","13","0","13","0","13","","0","0","0","0","0","0","0","0","0","0","0","0","0","0","0","0","0","0","0","0","28.10.12"
"000017","143","Одеська область","
""Украина""","0","3","25","0","23","0","23","","0","23","0","23","0","23","5","4","7","0","0","0","0","5","1","0","0","0","1","0","28.10.12"
"000018","143","Одеська область","
""Звенигород"" ","0","1","12","0","12","0","12","","0","12","0","12","0","12","1","2","3","0","1","0","0","2","2","1","0","0","0","0","28.10.12"
"000019","143","Одеська область","
""Ярославль"" ","0","1","10","0","10","0","10","","0","10","0","10","0","10","0","2","1","0","1","0","0","0","4","0","0","0","2","0","28.10.12"
"000021","143","Одеська область","
""Молдавия"" ","0","5","60","0","56","0","56","","0","56","0","56","0","56","3","25","1","1","3","1","1","5","4","2","7","0","2","1","28.10.12"
"000022","143","Одеська область","
""Волга""","0","4","60","0","57","0","57","","0","57","0","57","0","57","3","24","3","1","2","3","0","1","11","3","2","0","3","1","28.10.12"
"000023","143","Одеська область","
""Златоуст""","0","0","13","0","13","0","13","","0","0","0","0","0","0","0","0","0","0","0","0","0","0","0","0","0","0","0","0","28.10.12"
"000024","143","Одеська область","
""Капітан Жидков""","0","1","8","0","8","0","8","","0","8","0","8","0","8","0","0","8","0","0","0","0","0","0","0","0","0","0","0","28.10.12"
"000025","143","Одеська область","
""Іваново""","0","2","12","0","11","0","11","","0","11","0","11","0","11","0","0","0","0","0","0","0","1","0","10","0","0","0","0","28.10.12"
"000027","143","Одеська область","
""Пєрмь""","0","1","12","0","12","0","12","","0","12","0","12","0","12","0","0","1","0","0","0","0","2","1","3","1","0","0","4","28.10.12"
"000028","143","Одеська область","
""Ніколай Будніков""","0","1","8","0","8","0","8","","0","8","0","8","0","8","0","7","0","0","0","0","0","0","0","1","0","0","0","0","28.10.12"
"000029","143","Одеська область","
""Мєханік Головацкій""","0","1","8","0","8","0","8","","0","8","0","8","0","8","6","0","1","0","0","0","0","0","0","0","0","0","0","1","28.10.12"
"000032","143","Одеська область","
""Фьодор Рябінін""","0","2","7","0","7","0","7","","0","7","0","7","0","7","2","1","0","0","0","0","0","1","1","0","1","0","1","0","28.10.12"
"000033","143","Одеська область","
""Константін Борісов""","0","2","12","0","11","0","11","","0","0","0","0","0","0","0","0","0","0","0","0","0","0","0","0","0","0","0","0","28.10.12"
"510291","143","Одеська область","будинок культури, зала
вул.Леніна, 58А, с.Баннівка, Болградський р-н, Одеська обл., 68750","918","351","915","48","523","44","567","","0","523","44","567","14","553","1","38","79","2","1","0","0","21","364","37","5","0","4","1","28.10.12"
"510292","143","Одеська область","будинок культури, мала зала
вул.Карла Маркса, 108, с.Василівка, Болградський р-н, Одеська обл., 68752","1410","730","1396","70","615","65","680","","0","615","65","680","23","657","0","39","197","7","1","3","0","46","300","46","9","2","5","2","29.10.12"
"510293","143","Одеська область","школа, спортивна зала
вул.Шкільна, 17, с.Василівка, Болградський р-н, Одеська обл., 68752","1410","735","1399","67","615","60","675","","0","615","60","675","29","646","2","36","246","4","4","2","0","34","256","38","9","2","12","1","29.10.12"
"510294","143","Одеська область","будинок культури, фойє
вул.Гагаріна, 1, с.Виноградівка, Болградський р-н, Одеська обл., 68733","1530","850","1513","93","600","80","680","","0","600","80","680","29","651","3","54","302","3","3","0","0","66","169","44","2","2","0","3","29.10.12"
"510295","143","Одеська область","школа, фойє
вул.Гагаріна, 2, с.Виноградівка, Болградський р-н, Одеська обл., 68733","1638","1014","1625","51","577","47","624","","0","577","47","624","30","594","1","45","304","5","0","2","0","77","93","56","4","4","1","2","29.10.12"
"510297","143","Одеська область","будинок культури, велика зала
вул.Леніна, 37А, с.Владичень, Болградський р-н, Одеська обл., 68741","954","422","946","52","486","46","532","","0","486","46","532","19","513","2","50","103","10","1","4","3","58","187","50","41","2","1","1","29.10.12"
"510316","143","Одеська область","школа, спортивна зала
вул.Гагаріна, 76, с.Табаки, Болградський р-н, Одеська обл., 68730","1872","1082","1853","67","728","62","790","","0","728","62","790","27","763","1","131","259","6","2","1","4","16","263","72","6","1","0","1","29.10.12"
"510380","143","Одеська область","Багатянська школа, фойє
вул.Леніна, 20, с.Багате, Ізмаїльський р-н, Одеська обл., 68671","1548","892","1530","17","644","12","656","","0","644","12","656","41","615","2","106","85","2","4","5","5","59","172","34","38","47","18","38","29.10.12"
"510381","143","Одеська область","будинок культури, фойє
вул.Леніна, 24, с.Багате, Ізмаїльський р-н, Одеська обл., 68671","1392","879","1376","15","500","13","513","","0","500","13","513","25","488","9","79","71","3","8","10","1","48","141","44","23","27","9","15","29.10.12"
"510382","143","Одеська область","будинок культури, фойє
вул.Болградська, 94А, с.Броска, Ізмаїльський р-н, Одеська обл., 68663","1422","693","1411","35","697","32","729","","0","697","32","729","28","701","2","145","72","4","4","14","5","54","220","36","82","21","37","5","29.10.12"
"510383","143","Одеська область","Бросківська школа, фойє
вул.Болградська, 90, с.Броска, Ізмаїльський р-н, Одеська обл., 68663","1386","719","1357","30","641","26","667","","0","641","26","667","17","650","7","168","80","2","2","26","3","42","186","28","74","8","11","13","29.10.12"
"510384","143","Одеська область","будинок культури, фойє
вул.Леніна, 7, с.Каланчак, Ізмаїльський р-н, Одеська обл., 68642","1068","589","1057","34","448","31","479","","0","448","31","479","18","461","3","60","87","1","2","5","1","30","177","21","24","21","12","17","28.10.12"
"510385","143","Одеська область","будинок культури, зала
вул.Леніна, 94, с.Кам’янка, Ізмаїльський р-н, Одеська обл., 68643","1314","690","1297","59","566","58","624","","0","566","58","624","33","591","6","72","173","4","7","2","2","35","152","47","47","21","7","16","28.10.12"
"510386","143","Одеська область","сільська рада, актова зала
вул.Суворова, 4Г, с.Кам’янка, Ізмаїльський р-н, Одеська обл., 68643","1464","882","1452","38","548","34","582","","0","548","34","582","28","554","4","65","189","4","3","2","1","39","124","50","37","20","4","12","29.10.12"
"510387","143","Одеська область","будинок культури, к.2
вул.Комсомольська, 16Б, с.Комишівка, Ізмаїльський р-н, Одеська обл., 68653","2490","1756","2464","29","709","25","734","","0","709","25","734","51","683","7","94","72","5","4","3","3","35","255","57","39","16","4","89","29.10.12"
"510388","143","Одеська область","будинок культури, зала
вул.Шкільна, 2, с.Кирнички, Ізмаїльський р-н, Одеська обл., 68650","1728","929","1707","66","745","54","799","","0","745","54","799","29","770","5","140","158","7","10","5","2","65","227","39","52","18","26","16","28.10.12"
"510389","143","Одеська область","будинок культури, актова зала
вул.Кірова, 59, с.Кислиця, Ізмаїльський р-н, Одеська обл., 68655","2130","1159","2104","37","951","20","971","","0","951","20","971","62","909","5","253","111","7","6","28","0","87","197","54","89","31","14","27","29.10.12"
"510390","143","Одеська область","недіюча школа, фойє
вул.Радянська, 2А, с.Ларжанка, Ізмаїльський р-н, Одеська обл., 68662","1704","833","1673","39","836","35","871","","0","836","35","871","41","830","3","111","52","3","4","20","0","44","231","49","246","6","10","51","29.10.12"
"510391","143","Одеська область","будинок культури, фойє
вул.Ізмаїльська, 64А, с.Лощинівка, Ізмаїльський р-н, Одеська обл., 68644","1164","649","1137","27","490","25","515","","0","490","25","515","23","492","2","92","76","4","4","5","0","31","144","58","38","13","6","19","29.10.12"
"510392","143","Одеська область","Матроська школа, фойє
вул.Пушкіна, 26А, с.Матроська, Ізмаїльський р-н, Одеська обл., 68664","1752","875","1736","29","850","27","877","","0","850","27","877","34","843","7","175","100","4","4","13","1","45","233","50","175","7","22","7","29.10.12"
"510393","143","Одеська область","будинок культури, фойє
вул.Кутузова, 17, с.Муравлівка, Ізмаїльський р-н, Одеська обл., 68652","798","365","783","27","412","21","433","","0","412","21","433","28","405","3","80","91","1","2","3","2","17","103","22","64","3","3","11","29.10.12"
"510394","143","Одеська область","будинок культури, мала зала
вул.Леніна, 67А, с.Нова Некрасівка, Ізмаїльський р-н, Одеська обл., 68661","1482","681","1468","39","769","32","801","","0","769","32","801","27","774","9","62","138","4","2","8","1","43","170","35","247","14","26","15","29.10.12"
"510395","143","Одеська область","будинок культури, зала
вул.Радянська, 45, с.Нова Покровка, Ізмаїльський р-н, Одеська обл., 68651","636","231","622","49","361","44","405","","0","361","44","405","13","392","2","37","31","0","1","5","1","8","272","18","1","9","0","7","28.10.12"
"510396","143","Одеська область","Озерненська школа, фойє, праве крило
вул.1 Травня, 29А, с.Озерне, Ізмаїльський р-н, Одеська обл., 68660","1932","1198","1904","16","719","15","734","","0","719","15","734","51","683","3","191","63","5","7","14","4","89","183","12","47","22","13","30","29.10.12"
"510397","143","Одеська область","Озернянська школа, фойє, ліве крило
вул.1 Травня, 29А, с.Озерне, Ізмаїльський р-н, Одеська обл., 68660","2082","1400","2064","8","678","4","682","","0","678","4","682","17","665","5","85","104","3","5","7","1","57","231","15","71","28","14","39","29.10.12"
"510398","143","Одеська область","будинок культури, фойє
вул.Гагаріна, 83, с.Першотравневе, Ізмаїльський р-н, Одеська обл., 68654","1332","637","1305","59","638","57","695","","0","638","57","695","27","668","7","149","90","5","2","10","2","38","139","40","137","11","23","15","29.10.12"
"510399","143","Одеська область","Саф’янська школа, фойє
вул.Чапаєва, 41А, с.Саф’яни, Ізмаїльський р-н, Одеська обл., 68670","2202","1258","2171","36","912","32","944","","0","912","32","944","56","888","4","143","143","8","5","18","3","60","227","62","140","30","23","22","29.10.12"
"510400","143","Одеська область","сільська рада, зала засідань
вул.Ізмаїльська, 40, с.Стара Некрасівка, Ізмаїльський р-н, Одеська обл., 68672","2202","1258","2165","67","890","54","944","","0","890","54","944","49","895","10","145","79","2","5","14","1","34","286","64","169","54","23","9","29.10.12"
"510401","143","Одеська область","контора АК ""Свобода"", к.2
вул.Леніна, 1, с.Дунайське, Ізмаїльський р-н, Одеська обл., 68681","420","187","412","10","224","9","233","","0","224","9","233","8","225","1","18","70","0","1","3","1","7","55","13","37","15","1","3","28.10.12"
"510402","143","Одеська область","Суворівська школа, спортивна зала
вул.Пушкіна, 46, смт Суворове, Ізмаїльський р-н, Одеська обл., 68640","1842","1051","1825","27","775","16","791","","0","775","16","791","38","753","3","103","149","4","6","21","3","53","218","39","55","60","19","20","28.10.12"
"510403","143","Одеська область","будинок культури, репетиційна зала
вул.Леніна, 108, смт Суворове, Ізмаїльський р-н, Одеська обл., 68640","1578","899","1529","29","652","27","679","","0","652","27","679","18","661","4","84","145","3","5","9","1","57","194","39","45","43","15","17","29.10.12"
"510404","143","Одеська область","Утконосівська школа, фойє
вул.Шкільна, 2, с.Утконосівка, Ізмаїльський р-н, Одеська обл., 68645","1290","713","1282","10","569","8","577","","0","569","8","577","12","565","1","48","265","5","2","4","0","17","93","10","8","14","1","97","29.10.12"
"510405","143","Одеська область","будинок культури, фойє
вул.Леніна, 40, с.Утконосівка, Ізмаїльський р-н, Одеська обл., 68645","1812","902","1780","23","894","16","910","","0","894","16","910","13","897","3","69","534","6","2","4","1","29","89","9","15","15","5","116","29.10.12"
"510406","143","Одеська область","лікарня, лікарняні палати
вул.Кутузова, 10, смт Суворове, Ізмаїльський р-н, Одеська обл., 68640","42","18","36","10","17","7","24","","0","17","7","24","0","24","0","3","1","0","0","0","0","0","17","1","0","2","0","0","28.10.12"
"510707","143","Одеська область","залізнична станція, червоний куток
вул.Леніна, 36, м.Рені, Ренійський р-н, Одеська обл., 68800","1650","994","1615","35","625","31","656","","0","625","31","656","45","611","6","66","112","1","4","7","1","46","160","155","25","17","7","4","29.10.12"
"510708","143","Одеська область","школа №1, коридор
вул.Леніна, 46, м.Рені, Ренійський р-н, Одеська обл., 68800","1518","823","1491","49","656","39","695","","0","656","39","695","33","662","7","96","95","3","3","5","0","59","199","137","21","15","9","13","29.10.12"
"510709","143","Одеська область","школа №4, спортзал
вул.Кагульська, 31, м.Рені, Ренійський р-н, Одеська обл., 68800","1470","846","1451","40","589","35","624","","0","589","35","624","35","589","2","61","99","0","5","0","1","34","197","136","30","12","4","8","29.10.12"
"510710","143","Одеська область","будинок культури, кругла зала
вул.Гагаріна, 15, м.Рені, Ренійський р-н, Одеська обл., 68800","1638","842","1613","38","769","27","796","","0","769","27","796","22","774","12","133","134","2","4","1","1","68","215","124","52","10","9","9","29.10.12"
"510711","143","Одеська область","школа №3, коридор
вул.Радянська, 11, м.Рені, Ренійський р-н, Одеська обл., 68800","1344","642","1312","38","673","29","702","","0","673","29","702","27","675","8","94","112","3","2","2","2","57","162","157","46","18","6","6","29.10.12"
"510712","143","Одеська область","Центр дитячої та юнацької творчості, фойє
вул.28 Червня, 141, м.Рені, Ренійський р-н, Одеська обл., 68800","1326","735","1295","45","555","36","591","","0","555","36","591","32","559","6","61","93","3","1","2","0","53","171","127","21","11","4","6","05.11.12"
"510713","143","Одеська область","Ренійська гімназія, фойє
вул.Шевченко, 10, м.Рені, Ренійський р-н, Одеська обл., 68800","1380","693","1357","51","641","46","687","","0","641","46","687","28","659","3","73","143","5","6","4","0","60","194","116","34","11","3","7","29.10.12"
"510714","143","Одеська область","НВК школа-ліцей, спортзал
вул.28 Червня, 218, м.Рені, Ренійський р-н, Одеська обл., 68800","1812","999","1789","24","794","19","813","","0","794","19","813","41","772","6","123","94","3","4","3","3","81","226","118","71","18","9","13","29.10.12"
"510715","143","Одеська область","""Ренійський Райавтодор"", червоний куток
вул.Крайня, 75А, м.Рені, Ренійський р-н, Одеська обл., 68800","1680","1044","1663","31","621","15","636","","0","621","15","636","40","596","9","57","97","3","2","3","1","63","208","96","34","11","5","7","29.10.12"
"510716","143","Одеська область","школа №5, спортзал
вул.Анадольська, 25, м.Рені, Ренійський р-н, Одеська обл., 68800","1932","1120","1909","24","800","12","812","","0","800","12","812","48","764","6","117","105","4","2","2","3","79","263","107","39","18","10","9","29.10.12"
"510717","143","Одеська область","міський гуртожиток, актова зала
вул.28 Червня, 257, м.Рені, Ренійський р-н, Одеська обл., 68800","1596","999","1568","31","568","29","597","","0","568","29","597","39","558","7","84","83","3","5","2","1","66","125","113","44","10","8","7","29.10.12"
"510718","143","Одеська область","будинок культури, зал урочистих обрядів
вул.Леніна, 143, с.Долинське, Ренійський р-н, Одеська обл., 68810","1986","1112","1957","92","798","76","874","","0","798","76","874","38","836","9","56","292","9","2","5","2","92","245","60","26","16","4","18","29.10.12"
"510719","143","Одеська область","будинок культури, зала засідань
вул.Леніна, 61, с.Котловина, Ренійський р-н, Одеська обл., 68820","2112","1002","2090","92","1026","84","1110","","0","1026","84","1110","34","1076","3","43","150","3","4","3","6","467","279","88","17","7","5","1","29.10.12"
"510720","143","Одеська область","школа, фойє
вул.Комсомольська, 171, с.Лиманське, Ренійський р-н, Одеська обл., 68811","2442","1501","2405","102","857","84","941","","0","857","84","941","44","897","10","59","123","13","3","12","5","80","417","83","32","22","7","31","29.10.12"
"510721","143","Одеська область","школа, фойє
вул.Шевченко, 2, с.Нагірне, Ренійський р-н, Одеська обл., 68821","1956","947","1934","81","937","72","1009","","0","937","72","1009","34","975","4","126","215","1","1","5","2","53","417","81","37","21","6","6","29.10.12"
"510722","143","Одеська область","будинок культури, фойє
вул.Леніна, 52, с.Новосільське, Ренійський р-н, Одеська обл., 68830","2520","1520","2506","166","901","99","1000","","0","901","99","1000","40","960","7","64","112","3","9","5","2","132","512","37","17","30","8","22","28.10.12"
"510723","143","Одеська область","будинок культури, танцювальний зал
вул.Суворова, 59, с.Орлівка, Ренійський р-н, Одеська обл., 68831","2304","1372","2284","89","856","76","932","","0","856","76","932","42","890","3","48","246","6","3","9","2","44","337","143","12","17","7","13","29.10.12"
"510724","143","Одеська область","будинок культури, фойє
вул.Леніна, 97, с.Плавні, Ренійський р-н, Одеська обл., 68822","1470","749","1450","61","676","45","721","","0","676","45","721","21","700","2","63","93","2","5","4","3","68","276","141","13","15","4","11","29.10.12"
"510725","143","Одеська область","лікарня, актова зала
вул.Дунайська, 15, м.Рені, Ренійський р-н, Одеська обл., 68800","114","61","58","8","45","8","53","","0","45","8","53","2","51","0","8","2","1","0","0","0","4","26","6","4","0","0","0","29.10.12"
"510726","143","Одеська область","лікарня, їдальня
вул.Східна, 1А, м.Рені, Ренійський р-н, Одеська обл., 68800","114","80","39","11","25","9","34","","0","25","9","34","1","33","0","5","3","0","3","0","1","1","13","6","1","0","0","0","28.10.12"
"510978","143","Одеська область","школа №8, їдальня, ліве крило
вул.Нахімова, 411, м.Ізмаїл, Одеська обл., 68600","2382","1240","2323","27","1115","27","1142","","0","1115","27","1142","39","1103","22","182","195","8","3","39","5","90","176","93","200","15","60","15","29.10.12"
"510979","143","Одеська область","школа №8, вестибюль, праве крило, 1-й поверх
вул.Нахімова, 411, м.Ізмаїл, Одеська обл., 68600","2412","1417","2385","45","958","37","995","","0","958","37","995","45","950","7","158","124","8","6","28","2","60","164","77","208","20","68","20","29.10.12"
"510980","143","Одеська область","школа №14, їдальня, ліве крило
вул.Нижньосадова, 5А, м.Ізмаїл, Одеська обл., 68600","2370","1386","2330","22","963","21","984","","0","963","21","984","41","943","12","157","121","3","3","24","2","72","152","63","222","19","78","15","29.10.12"
"510981","143","Одеська область","школа №14, вестибюль, праве крило, 1-й поверх
вул.Нижньосадова, 5А, м.Ізмаїл, Одеська обл., 68600","2442","1402","2401","22","1019","21","1040","","0","1019","21","1040","46","994","13","154","110","5","3","40","0","76","170","67","263","24","48","21","29.10.12"
"510982","143","Одеська область","школа №5, їдальня
вул.Дзержинського, 105, м.Ізмаїл, Одеська обл., 68600","2244","1269","2229","15","964","11","975","","0","964","11","975","57","918","8","150","132","3","8","24","1","54","138","83","242","18","48","9","29.10.12"
"510983","143","Одеська область","школа №6, актова зала
вул.Жовтнева, 74, м.Ізмаїл, Одеська обл., 68600","2286","1275","2253","61","962","49","1011","","0","962","49","1011","33","978","24","130","115","3","7","16","3","57","137","66","330","23","50","17","29.10.12"
"510984","143","Одеська область","будинок вчителя, актова зала
вул.Кірова, 42, м.Ізмаїл, Одеська обл., 68600","2268","1266","2221","23","983","19","1002","","0","983","19","1002","34","968","15","153","108","6","4","20","2","69","158","91","239","25","70","8","29.10.12"
"510985","143","Одеська область","школа №3, актова зала
вул.Пушкіна, 123, м.Ізмаїл, Одеська обл., 68600","2292","1364","2274","10","921","7","928","","0","921","7","928","44","884","19","124","110","7","3","27","3","79","123","60","208","24","83","14","29.10.12"
"510986","143","Одеська область","школа №16, вестибюль
вул.28 Червня, 102, м.Ізмаїл, Одеська обл., 68600","2364","1365","2335","38","965","34","999","","0","965","34","999","43","956","11","124","145","2","8","34","4","64","137","70","237","19","83","18","29.10.12"
"510987","143","Одеська область","будинок культури, фойє
пр.Суворова, 44, м.Ізмаїл, Одеська обл., 68600","2088","1081","2037","40","971","36","1007","","0","971","36","1007","38","969","41","153","113","3","11","30","3","75","144","90","197","22","74","13","29.10.12"
"510988","143","Одеська область","медичне училище, актова зала
вул.Некрасова, 3А, м.Ізмаїл, Одеська обл., 68600","1998","1204","1980","18","782","12","794","","0","782","12","794","44","750","7","112","78","2","4","26","3","34","94","60","243","13","65","9","29.10.12"
"510989","143","Одеська область","ПАТ ""Ізмаїлавтотранс"", актова зала
вул.Чехова, 4, м.Ізмаїл, Одеська обл., 68600","2202","1308","2182","10","888","6","894","","0","888","6","894","41","853","15","119","87","3","7","22","2","71","111","44","280","20","60","12","29.10.12"
"510990","143","Одеська область","школа №11, спортивна зала, ліве крило
пр.Суворова, 186, м.Ізмаїл, Одеська обл., 68600","2328","1336","2293","17","977","15","992","","0","977","15","992","47","945","12","130","95","5","7","40","1","80","109","43","316","21","69","17","29.10.12"
"510991","143","Одеська область","школа №11, актова зала, праве крило
пр.Суворова, 186, м.Ізмаїл, Одеська обл., 68600","2394","1325","2343","40","1032","37","1069","","0","1032","37","1069","53","1016","15","110","122","3","7","38","2","80","160","71","260","16","104","28","29.10.12"
"510992","143","Одеська область","Управління водного господарства, актова зала
вул.Радянська, 87А, м.Ізмаїл, Одеська обл., 68600","2478","1326","2460","33","1121","31","1152","","0","1121","31","1152","45","1107","12","128","156","5","14","63","4","86","216","59","218","37","75","34","29.10.12"
"510993","143","Одеська область","професійно-технічне училище, їдальня
вул.Рєпіна, 14А, м.Ізмаїл, Одеська обл., 68600","1620","874","1587","21","727","19","746","","0","727","19","746","23","723","17","87","97","1","3","17","2","49","95","51","188","18","88","10","29.10.12"
"510994","143","Одеська область","Ізмаїльський державний гуманітарний університет, учбовий корпус №1, вестибюль
вул.Рєпіна, 12, м.Ізмаїл, Одеська обл., 68600","2382","1296","2371","20","1068","18","1086","","0","1068","18","1086","43","1043","38","134","119","5","9","34","3","111","155","81","206","31","101","16","29.10.12"
"510995","143","Одеська область","технікум механізації і електрофікації сільського господарства, вестибюль
пр.Суворова, 81, м.Ізмаїл, Одеська обл., 68600","2220","1169","2202","63","995","56","1051","","0","995","56","1051","45","1006","30","112","145","1","4","53","1","98","116","89","206","17","115","19","29.10.12"
"510996","143","Одеська область","школа №10, спортивна зала
вул.Івана Франка, 17, м.Ізмаїл, Одеська обл., 68600","2094","1003","2064","36","1061","30","1091","","0","1061","30","1091","34","1057","44","152","153","1","4","44","3","71","119","73","234","20","114","25","29.10.12"
"510997","143","Одеська область","Ізмаїльський державний гуманітарний університет, вестибюль
пр.Леніна, 9, м.Ізмаїл, Одеська обл., 68600","2400","1260","2356","29","1121","19","1140","","0","1121","19","1140","40","1100","72","109","129","4","17","35","6","91","171","103","206","25","113","19","29.10.12"
"510998","143","Одеська область","професійно-технічне училище сфери послуг, фойє
пр.Леніна, 15, м.Ізмаїл, Одеська обл., 68600","2466","1135","2453","32","1306","25","1331","","0","1306","25","1331","46","1285","43","135","143","5","9","42","6","103","156","139","308","19","157","20","05.11.12"
"510999","143","Одеська область","дитяча школа мистецтв, вестибюль
пр.Леніна, 17А, м.Ізмаїл, Одеська обл., 68600","2478","1195","2415","44","1245","38","1283","","0","1245","38","1283","42","1241","59","146","143","5","6","33","1","148","59","114","338","21","152","16","29.10.12"
"511000","143","Одеська область","школа №9, вестибюль старшої школи, праве крило
вул.Івана Франка, 8, м.Ізмаїл, Одеська обл., 68600","2154","1088","2115","23","1046","20","1066","","0","1046","20","1066","51","1015","46","124","126","5","5","24","2","70","121","122","194","10","135","31","29.10.12"
"511001","143","Одеська область","школа №9, вестибюль, ліве крило
вул.Івана Франка, 8, м.Ізмаїл, Одеська обл., 68600","2388","1199","2358","21","1172","17","1189","","0","1172","17","1189","36","1153","44","145","150","6","7","31","1","106","151","68","285","24","125","10","29.10.12"
"511002","143","Одеська область","Ізмаїльський державний гуманітарний університет, ауд.209, 2-й поверх
пр.Суворова, 75, м.Ізмаїл, Одеська обл., 68600","2334","1246","2283","51","1045","43","1088","","0","1045","43","1088","42","1046","43","125","162","1","10","34","3","64","152","80","215","25","122","10","29.10.12"
"511003","143","Одеська область","політехнічний ліцей, вестибюль навчального корпусу
пр.Суворова, 53, м.Ізмаїл, Одеська обл., 68600","2436","1263","2408","31","1145","28","1173","","0","1145","28","1173","32","1141","46","156","145","7","7","24","0","93","160","112","255","28","93","15","29.10.12"
"511004","143","Одеська область","школа №1, їдальня
вул.Жовтнева, 57, м.Ізмаїл, Одеська обл., 68600","2214","1147","2187","45","1024","43","1067","","0","1024","43","1067","37","1030","28","155","100","2","9","28","1","87","167","87","248","14","88","16","29.10.12"
"511005","143","Одеська область","Ізмаїльське вище професійне училище, фойє, 1-й поверх
вул.Фанагорійська, 7, м.Ізмаїл, Одеська обл., 68600","1932","1146","1938","18","771","15","786","","0","770","15","785","27","758","18","123","95","4","2","14","0","69","112","48","222","9","34","8","29.10.12"
"511006","143","Одеська область","центр здоров’я, актова зала
пр.Суворова, 68, м.Ізмаїл, Одеська обл., 68600","276","220","66","56","9","47","56","","0","9","47","56","2","54","1","4","13","1","1","2","0","1","12","6","2","3","6","2","28.10.12"
"511007","143","Одеська область","центральна района лікарня, актова зала
вул.Білгород-Дністровська, 31, м.Ізмаїл, Одеська обл., 68600","162","118","48","3","41","3","44","","0","41","3","44","4","40","0","7","5","0","0","0","0","1","16","3","3","1","3","1","29.10.12"
"511008","143","Одеська область","міська лікарня №3, кімната ""Червоний куток""
вул.Шевченка, 1, м.Ізмаїл, Одеська обл., 68600","60","45","15","0","15","0","15","","0","15","0","15","1","14","0","1","1","0","1","1","0","1","4","1","3","1","0","0","29.10.12"
"511009","143","Одеська область","Дунайська басейнова лікарня, конференц-зала цокольного поверху
вул.Железнякова, 182, м.Ізмаїл, Одеська обл., 68600","162","125","38","17","21","16","37","","0","21","16","37","2","35","0","7","9","0","0","0","0","1","5","6","4","1","2","0","28.10.12"
"511010","143","Одеська область","перинатальний центр, кабінет заступника головного лікаря
вул.Леніна, 111А, м.Ізмаїл, Одеська обл., 68600","102","84","44","0","18","0","18","","0","18","0","18","1","17","0","1","1","0","0","2","0","1","4","2","4","1","0","1","29.10.12"
"511011","143","Одеська область","інфекційна лікарня, актова зала
вул.Тельмана, 3, м.Ізмаїл, Одеська обл., 68600","72","56","20","1","15","1","16","","0","15","1","16","0","16","2","1","3","0","0","0","0","1","3","2","1","1","2","0","29.10.12"
"511012","143","Одеська область","міська лікарня №2, к.9
вул.Радянська, 75, м.Ізмаїл, Одеська обл., 68600","84","66","18","0","18","0","18","","0","18","0","18","0","18","0","1","4","0","0","0","0","2","6","1","2","1","1","0","28.10.12"
"511013","143","Одеська область","дермато-венерологічна лікарня, к.7
вул.Болградська, 76, м.Ізмаїл, Одеська обл., 68600","36","20","18","0","16","0","16","","0","16","0","16","0","16","0","0","4","0","1","0","0","0","5","3","2","1","0","0","28.10.12"
