"№ ВД","OBO","Назва регіону України","Місцезнаходження та адреса приміщення для голосування","1) К-сть одержаних бюлетенів","2) К-сть невикористаних бюлетенів","3) К-сть виборців, внесених до списку виборців","4) К-сть виборців, внесених до витягу зі списку виборців","5) К-сть виборців, які отримали бюлетені у приміщенні","6) К-сть виборців, які отримали за місцем перебування","7) Сумарна к-сть виборців, які отримали бюлетені","8) К-сть бюлетенів, що виявилися у кожній скринці","9) К-сть бюлетенів, що не підлягають врахуванню","10) К-сть виборців, які взяли участь у голос. у приміщенні для гол.","11) К-сть виборців, які взяли участь у голос. за місцем перебування","12) К-сть виборців, які взяли участь у голосуванні на виборчій дільниці","13) К-сть бюлетенів, визнаних недійсними","14) Сумарна к-сть голосів виборців ЗА","Козловський
Анатолій
Михайлович","Корнацький
Аркадій
Олексійович","Пєшехонов
Анатолій
Анатолійович","Романюк
Анатолій
Сергійович","Терьохін
Сергій
Євгенович","Толубко
Володимир
Борисович","Травянко
Віталій
Іванович","Дата підписання протоколу"
"480001","132","Миколаївська область","РК ТСОУ, к.2А, 1-й поверх
вул.Шевченка, 91, смт Арбузинка, Арбузинський р-н, Миколаївська обл., 55301","696","213","707","46","439","44","483","","0","439","44","483","11","472","24","121","18","44","5","22","238","29.10.12"
"480002","132","Миколаївська область","школа №2, спортивний зал, 1-й поверх
вул.Шевченка, 203, смт Арбузинка, Арбузинський р-н, Миколаївська обл., 55301","1120","399","1130","50","676","45","721","","0","676","45","721","16","705","31","194","16","80","8","17","359","29.10.12"
"480003","132","Миколаївська область","Арбузинський аграрний ліцей, фойє, 2-й поверх
вул.Шевченка, 219, смт Арбузинка, Арбузинський р-н, Миколаївська обл., 55301","1088","523","1086","51","514","51","565","","0","514","51","565","27","538","30","131","5","34","0","23","315","28.10.12"
"480004","132","Миколаївська область","школа №1, к.1, 1-й поверх
вул.Шкільна, 96, смт Арбузинка, Арбузинський р-н, Миколаївська обл., 55301","848","359","864","46","449","40","489","","0","449","40","489","30","459","36","105","6","40","2","12","258","29.10.12"
"480005","132","Миколаївська область","адміністративне приміщення ЗАТ ""УКРАЇНА"", актовий зал, 2-й поверх
вул.Учительська, 38, смт Арбузинка, Арбузинський р-н, Миколаївська обл., 55301","640","301","642","25","316","23","339","","0","316","23","339","13","326","21","93","9","34","6","12","151","29.10.12"
"480006","132","Миколаївська область","МБК ЗАТ ""Україна"", глядацький зал, 1-й поверх
вул.Учительська, 138, смт Арбузинка, Арбузинський р-н, Миколаївська обл., 55301","592","224","600","53","319","49","368","","0","319","49","368","17","351","30","104","9","49","4","12","143","28.10.12"
"480007","132","Миколаївська область","будинок культури, зал, 1-й поверх
вул.Фрунзе, 47, с.Полянка, Арбузинський р-н, Миколаївська обл., 55311","256","124","248","9","125","7","132","","0","125","7","132","4","128","7","51","4","11","3","3","49","29.10.12"
"480008","132","Миколаївська область","міський будинок культури, фойє, 1-й поверх
пл.Жовтневої революції, 18, смт Костянтинівка, Арбузинський р-н, Миколаївська обл., 55340","1064","548","1050","34","489","27","516","","0","489","27","516","33","483","65","133","3","18","5","24","235","28.10.12"
"480009","132","Миколаївська область","школа, фойє, 1-й поверх
вул.Садова, 2, смт Костянтинівка, Арбузинський р-н, Миколаївська обл., 55340","1104","577","1102","33","497","30","527","","0","497","30","527","26","501","55","111","7","24","3","24","277","29.10.12"
"480010","132","Миколаївська область","школа, к.10, 1-й поверх
вул.Шкільна, 31, с.Бузьке, Арбузинський р-н, Миколаївська обл., 55342","192","77","184","12","103","12","115","","0","103","12","115","2","113","14","28","0","6","2","0","63","28.10.12"
"480011","132","Миколаївська область","школа, спортивний зал, 1-й поверх
вул.50 років ВЛКСМ, 62, с-ще Кавуни, Арбузинський р-н, Миколаївська обл., 55026","640","235","628","28","377","28","405","","0","377","28","405","17","388","28","101","2","20","6","12","219","29.10.12"
"480012","132","Миколаївська область","будинок культури, фойє, 1-й поверх
пров.Парковий, 2, с.Агрономія, Арбузинський р-н, Миколаївська обл., 55353","880","351","924","31","498","31","529","","0","498","31","529","48","481","21","88","6","16","4","7","339","29.10.12"
"480013","132","Миколаївська область","будинок культури, фойє, 1-й поверх
вул.Ювілейна, 18, с.Благодатне, Арбузинський р-н, Миколаївська обл., 55325","1128","512","1116","56","564","52","616","","0","564","52","616","28","588","43","90","3","51","9","17","375","28.10.12"
"480014","132","Миколаївська область","будинок культури, фойє, 1-й поверх
вул.Лісова, 1, с.Воєводське, Арбузинський р-н, Миколаївська обл., 55320","936","490","929","44","406","40","446","","0","406","40","446","15","431","14","129","5","91","6","11","175","29.10.12"
"480015","132","Миколаївська область","будинок культури, фойє, 1-й поверх
вул.Горького, 16, с.Іванівка, Арбузинський р-н, Миколаївська обл., 55332","424","129","420","16","279","16","295","","0","279","16","295","13","282","11","79","9","14","1","13","155","29.10.12"
"480016","132","Миколаївська область","школа, спортивний зал, 1-й поверх
вул.Шкільна, 22, с.Панкратове, Арбузинський р-н, Миколаївська обл., 55333","224","77","214","24","123","24","147","","0","123","24","147","8","139","10","20","0","2","1","3","103","29.10.12"
"480017","132","Миколаївська область","школа, спортивний зал, 1-й поверх
вул.70-років Жовтня, 28, с.Любоіванівка, Арбузинський р-н, Миколаївська обл., 55324","264","109","263","20","140","15","155","","0","140","15","155","0","155","13","33","0","10","0","0","99","28.10.12"
"480018","132","Миколаївська область","сільський клуб, актовий зал, 1-й поверх
вул.Леніна, 10А, с.Новогригорівка, Арбузинський р-н, Миколаївська обл., 55321","248","83","249","17","150","15","165","","0","150","15","165","4","161","12","33","3","5","2","1","105","28.10.12"
"480019","132","Миколаївська область","школа, спортивний зал, 1-й поверх
вул.Величка, 23, с.Новокрасне, Арбузинський р-н, Миколаївська обл., 55323","992","473","982","36","489","30","519","","0","489","30","519","13","506","26","56","8","44","4","10","358","29.10.12"
"480020","132","Миколаївська область","школа, фойє, 1-й поверх
вул.Шкільна, 7, с.Новоселівка, Арбузинський р-н, Миколаївська обл., 55010","336","111","332","14","211","14","225","","0","211","14","225","10","215","17","56","1","13","0","0","128","28.10.12"
"480021","132","Миколаївська область","школа, спортивний зал, 1-й поверх
пров.Шкільний, 1, с.Мар’янівка, Арбузинський р-н, Миколаївська обл., 55010","392","143","392","14","235","14","249","","0","235","14","249","10","239","14","92","3","10","2","2","116","29.10.12"
"480022","132","Миколаївська область","Вольський ФАП, к.1, 1-й поверх
вул.Молодіжна, 2, с.Воля, Арбузинський р-н, Миколаївська обл., 55010","112","37","115","3","72","3","75","","0","72","3","75","1","74","8","19","0","2","0","1","44","28.10.12"
"480023","132","Миколаївська область","школа, фойє, 1-й поверх
вул.Набережна, 1, с.Рябоконеве, Арбузинський р-н, Миколаївська обл., 55322","264","103","263","8","153","8","161","","0","153","8","161","7","154","16","44","2","12","5","7","68","29.10.12"
"480024","132","Миколаївська область","будинок культури, глядацький зал, 1-й поверх
вул.Миру, 6, с.Садове, Арбузинський р-н, Миколаївська обл., 55312","744","330","743","34","386","28","414","","0","386","28","414","15","399","27","72","5","13","1","5","276","29.10.12"
"480025","132","Миколаївська область","будинок культури, фойє, 1-й поверх
вул.Леніна, 46, с.Семенівка, Арбузинський р-н, Миколаївська обл., 55330","1144","450","1137","54","640","54","694","","0","640","54","694","19","675","47","97","3","11","4","3","510","29.10.12"
"480026","132","Миколаївська область","сільський клуб, глядацький зал, 1-й поверх
вул.Шкільна, 1, с.Остапівка, Арбузинський р-н, Миколаївська обл., 55331","136","47","134","12","77","12","89","","0","77","12","89","0","89","13","18","2","3","1","0","52","28.10.12"
"480027","132","Миколаївська область","виправна колонія, кімната виховної роботи №4, 1-й поверх
вул.Дзержинського, 1, смт Костянтинівка, Арбузинський р-н, Миколаївська обл., 55340","1168","37","1154","0","1131","0","1131","","0","1131","0","1131","27","1104","70","64","3","38","1","3","925","29.10.12"
"480130","132","Миколаївська область","гімназія, фойє
вул.Піонерська, 30, смт Братське, Братський р-н, Миколаївська обл., 55401","2008","951","1999","43","1019","38","1057","","0","1019","38","1057","46","1011","96","392","15","111","13","53","331","29.10.12"
"480131","132","Миколаївська область","їдальня професійно-технічного училища 17, фойє
вул.Вороніна, 2, смт Братське, Братський р-н, Миколаївська обл., 55401","2192","1079","2185","26","1087","26","1113","","0","1087","26","1113","52","1061","102","448","19","143","8","47","294","29.10.12"
"480132","132","Миколаївська область","контора ФГ ""Світанок"", фойє
вул.Нагірна, 35, смт Братське, Братський р-н, Миколаївська обл., 55401","544","270","546","32","246","28","274","","0","246","28","274","14","260","26","74","6","43","5","14","92","29.10.12"
"480133","132","Миколаївська область","контора ТОВ ""Білоусівка"", фойє
вул.Паркова, 1А, с.Антонове, Братський р-н, Миколаївська обл., 55410","288","116","286","9","165","7","172","","0","165","7","172","8","164","23","58","4","29","1","5","44","28.10.12"
"480134","132","Миколаївська область","школа, фойє
вул.Шкільна, 12, с.Кам’януватка, Братський р-н, Миколаївська обл., 55411","232","76","236","8","148","8","156","","0","148","8","156","5","151","6","51","3","14","1","1","75","29.10.12"
"480135","132","Миколаївська область","сільський клуб, глядачевий зал
вул.Єсеніна, 26, с.Озеринівка, Братський р-н, Миколаївська обл., 55401","104","63","93","6","37","4","41","","0","37","4","41","0","41","6","12","0","3","0","1","19","28.10.12"
"480136","132","Миколаївська область","школа, фойє
вул.Шкільна, 8, с.Ганнівка, Братський р-н, Миколаївська обл., 55430","472","229","460","18","226","17","243","","0","226","17","243","15","228","32","53","6","23","1","6","107","28.10.12"
"480137","132","Миколаївська область","школа, фойє
вул.Воронина, 4, с.Мостове, Братський р-н, Миколаївська обл., 55432","200","64","199","6","131","5","136","","0","131","5","136","8","128","16","50","3","10","2","4","43","28.10.12"
"480138","132","Миколаївська область","будинок культури, фойє
вул.Першотравнева, 61В, с.Григорівка, Братський р-н, Миколаївська обл., 55420","336","162","330","7","168","6","174","","0","168","6","174","10","164","34","32","4","14","3","6","71","28.10.12"
"480139","132","Миколаївська область","сільський клуб, глядачевий зал
вул.Садова, 89, с.Антонівка, Братський р-н, Миколаївська обл., 55420","232","78","225","20","134","20","154","","0","134","20","154","2","152","25","29","1","15","3","2","77","29.10.12"
"480140","132","Миколаївська область","сільський клуб, глядачевий зал
вул.Привокзальна, 1, с-ще Людмилівка, Братський р-н, Миколаївська обл., 55423","440","179","429","13","252","9","261","","0","252","9","261","18","243","21","46","5","22","0","5","144","29.10.12"
"480141","132","Миколаївська область","школа, актова зала
вул.Набережна, 65, с.Михайло-Жукове, Братський р-н, Миколаївська обл., 55423","280","93","284","13","174","13","187","","0","174","13","187","14","173","11","37","5","25","2","5","88","29.10.12"
"480142","132","Миколаївська область","школа, фойє
вул.Набережна, 26, с.Іллічівка, Братський р-н, Миколаївська обл., 55472","368","165","367","13","193","10","203","","0","193","10","203","8","195","23","74","8","16","2","3","69","28.10.12"
"480143","132","Миколаївська область","школа, фойє
вул.70 років Жовтня, 18, с.Микільське, Братський р-н, Миколаївська обл., 55485","232","83","228","8","141","8","149","","0","141","8","149","6","143","17","32","8","19","7","5","55","28.10.12"
"480144","132","Миколаївська область","школа, фойє
вул.Шкільна, 17, с.Кам’яно-Костувате, Братський р-н, Миколаївська обл., 55442","312","127","314","9","180","5","185","","0","180","5","185","4","181","16","73","3","15","3","3","68","28.10.12"
"480145","132","Миколаївська область","школа, фойє
вул.Шкільна, 48, с.Костувате, Братський р-н, Миколаївська обл., 55434","352","70","364","34","259","23","282","","0","259","23","282","9","273","18","42","4","10","4","9","186","28.10.12"
"480146","132","Миколаївська область","будинок культури, фойє
вул.Хмеленка, 27, с.Крива Пустош, Братський р-н, Миколаївська обл., 55450","416","151","406","37","230","35","265","","0","230","35","265","16","249","20","83","5","11","3","7","120","29.10.12"
"480147","132","Миколаївська область","сільський клуб, глядачевий зал
вул.Гамазіна, 2, с.Миколаївка, Братський р-н, Миколаївська обл., 55460","384","145","384","5","234","5","239","","0","234","5","239","13","226","19","59","4","29","3","7","105","28.10.12"
"480148","132","Миколаївська область","будинок культури, фоєй
вул.Щорса, 35, с.Миролюбівка, Братський р-н, Миколаївська обл., 55444","424","85","422","14","325","14","339","","0","325","14","339","16","323","18","59","2","12","1","4","227","28.10.12"
"480149","132","Миколаївська область","школа, фойє
вул.Миру, 45, с.Новокостянтинівка, Братський р-н, Миколаївська обл., 55482","752","268","754","41","447","37","484","","0","447","37","484","16","468","28","118","7","23","3","11","278","29.10.12"
"480150","132","Миколаївська область","бібліотека, читальний зал
вул.Жовтнева, 3А, с.Надеждівка, Братський р-н, Миколаївська обл., 55485","192","66","190","16","110","16","126","","0","110","16","126","3","123","10","33","0","11","3","2","64","28.10.12"
"480151","132","Миколаївська область","школа, фойє
пров.Шкільний, 8, с.Новомар’ївка, Братський р-н, Миколаївська обл., 55424","416","142","413","26","250","24","274","","0","250","24","274","9","265","16","50","6","17","2","2","172","28.10.12"
"480152","132","Миколаївська область","сільський клуб, глядачевий зал
вул.Горького, 8А, с.Обухівка, Братський р-н, Миколаївська обл., 55425","320","88","324","17","217","15","232","","0","217","15","232","1","231","16","41","5","8","1","1","159","29.10.12"
"480153","132","Миколаївська область","школа, фойє
вул.Чапаєва, 1, с.Новоолександрівка, Братський р-н, Миколаївська обл., 55480","448","197","440","15","237","14","251","","0","237","14","251","14","237","27","66","6","16","1","5","116","29.10.12"
"480154","132","Миколаївська область","школа, фойє
вул.Шкільна, 2, с.Петропавлівка, Братський р-н, Миколаївська обл., 55462","408","164","399","25","224","20","244","","0","224","20","244","11","233","18","77","2","20","0","6","110","29.10.12"
"480155","132","Миколаївська область","будинок культури, фойє
вул.Філімонова, 20А, с.Сергіївка, Братський р-н, Миколаївська обл., 55440","560","237","560","9","315","8","323","","0","315","8","323","13","310","13","75","6","25","3","12","176","29.10.12"
"480156","132","Миколаївська область","школа, актова зала
вул.Гагаріна, 10, с.Улянівка, Братський р-н, Миколаївська обл., 55452","352","95","353","8","250","7","257","","0","250","7","257","10","247","26","90","6","17","1","6","101","29.10.12"
"480157","132","Миколаївська область","школа, фойє
вул.Шмадченка, 3, с.Соколівка, Братський р-н, Миколаївська обл., 55453","184","53","180","2","129","2","131","","0","129","2","131","9","122","7","27","0","11","1","2","74","28.10.12"
"480158","132","Миколаївська область","будинок культури, фойє
вул.Шевченка, 26, с.Шевченко, Братський р-н, Миколаївська обл., 55470","400","176","389","16","210","14","224","","0","210","14","224","10","214","21","81","5","17","3","10","77","29.10.12"
"480222","132","Миколаївська область","СТОВ АФ ""Україна"", актова зала
вул.Героїв Врадіївщини, 61, смт Врадіївка, Врадіївський р-н, Миколаївська обл., 56301","1880","1028","1844","69","796","56","852","","0","796","56","852","48","804","81","327","23","72","19","43","239","29.10.12"
"480223","132","Миколаївська область","районна гімназія, фойє
вул.Горького, 112, смт Врадіївка, Врадіївський р-н, Миколаївська обл., 56301","2096","1161","2078","64","879","56","935","","0","879","56","935","30","905","82","337","44","101","11","42","288","29.10.12"
"480224","132","Миколаївська область","районний будинок культури, танцювальний зал
вул.Маяковського, 94, смт Врадіївка, Врадіївський р-н, Миколаївська обл., 56301","1752","1020","1710","52","689","43","732","","0","689","43","732","26","706","56","254","15","86","15","30","250","29.10.12"
"480225","132","Миколаївська область","ДП ""Врадіївський лісгосп"", актова зала
вул.Чкалова, 46, смт Врадіївка, Врадіївський р-н, Миколаївська обл., 56301","944","515","941","21","412","17","429","","0","412","17","429","17","412","42","149","10","38","11","17","145","29.10.12"
"480226","132","Миколаївська область","селищний будинок культури, глядацький зал
вул.Орджонікідзе, 145, смт Врадіївка, Врадіївський р-н, Миколаївська обл., 56301","808","456","798","11","343","9","352","","0","343","9","352","34","318","32","137","7","27","5","19","91","29.10.12"
"480227","132","Миколаївська область","сільський клуб, фойє
вул.Центральна, 27, с.Адамівка, Врадіївський р-н, Миколаївська обл., 56303","536","208","518","25","306","22","328","","0","306","22","328","12","316","8","54","8","12","1","22","211","29.10.12"
"480228","132","Миколаївська область","школа, фойє, 2-й поверх
вул.Шкільна, 29, с.Великовеселе, Врадіївський р-н, Миколаївська обл., 56340","400","200","398","31","170","30","200","","0","170","30","200","5","195","15","64","8","24","3","7","74","29.10.12"
"480229","132","Миколаївська область","початкова школа, другий клас
вул.Шкільна, 1, с.Новоолексіївка, Врадіївський р-н, Миколаївська обл., 56340","128","67","121","1","60","1","61","","0","60","1","61","2","59","4","19","4","8","1","0","23","29.10.12"
"480230","132","Миколаївська область","сільський будинок культури, фойє
вул.Леніна, 34, с.Гуляницьке, Врадіївський р-н, Миколаївська обл., 56323","552","237","549","23","292","23","315","","0","292","23","315","9","306","14","123","18","29","7","19","96","29.10.12"
"480231","132","Миколаївська область","сільский клуб, глядацкий зал
вул.Леніна, 19, с.Йосипівка, Врадіївський р-н, Миколаївська обл., 56325","208","97","199","13","98","13","111","","0","98","13","111","6","105","12","39","1","2","3","5","43","29.10.12"
"480232","132","Миколаївська область","школа, фойє
вул.Шкільна, 2А, с.Доброжанівка, Врадіївський р-н, Миколаївська обл., 56312","368","160","358","9","200","8","208","","0","200","8","208","5","203","13","65","21","25","1","4","74","29.10.12"
"480233","132","Миколаївська область","сільський будинок культури, фойє
вул.Леніна, 40, с.Богемка, Врадіївський р-н, Миколаївська обл., 56314","312","107","310","5","200","5","205","","0","200","5","205","8","197","9","104","6","18","2","8","50","29.10.12"
"480234","132","Миколаївська область","сільський будинок культури, фойє
вул.Новоселів, 13В, с.Новомиколаївське, Врадіївський р-н, Миколаївська обл., 56312","216","82","209","10","124","10","134","","0","124","10","134","1","133","4","49","5","3","4","7","61","29.10.12"
"480235","132","Миколаївська область","школа, фойє
вул.Центральна, 4, с.Жовтневе, Врадіївський р-н, Миколаївська обл., 56315","448","184","440","4","260","4","264","","0","260","4","264","9","255","16","167","1","10","2","7","52","29.10.12"
"480236","132","Миколаївська область","школа, їдальня
вул.Миру, 7, с.Іванівка, Врадіївський р-н, Миколаївська обл., 56330","272","123","265","13","137","12","149","","0","137","12","149","9","140","10","91","1","4","1","4","29","29.10.12"
"480237","132","Миколаївська область","школа, фойє
вул.Центральна, 7, с.Захарівка, Врадіївський р-н, Миколаївська обл., 56330","288","143","284","16","132","13","145","","0","132","13","145","2","143","13","53","11","7","0","1","58","29.10.12"
"480238","132","Миколаївська область","будинок культури, фойє
вул.Миру, 134, с.Кумарі, Врадіївський р-н, Миколаївська обл., 56309","352","141","348","19","192","19","211","","0","192","19","211","8","203","5","94","4","18","2","16","64","29.10.12"
"480239","132","Миколаївська область","школа, фойє
вул.Молодіжна, 2, с.Краснопіль, Врадіївський р-н, Миколаївська обл., 56320","304","128","295","29","155","21","176","","0","155","21","176","5","171","16","53","9","6","2","7","78","28.10.12"
"480240","132","Миколаївська область","школа, спортивний зал
вул.Центральна, 48, с.Федорівка, Врадіївський р-н, Миколаївська обл., 56320","312","125","306","24","166","21","187","","0","166","21","187","2","185","13","35","3","23","1","9","101","28.10.12"
"480241","132","Миколаївська область","школа, фойє
вул.Шкільна, 1А, с.Нововасилівка, Врадіївський р-н, Миколаївська обл., 56332","552","350","542","11","193","9","202","","0","193","9","202","10","192","16","81","5","11","2","21","56","29.10.12"
"480242","132","Миколаївська область","школа, коридор
вул.Леніна, 38, с.Новопавлівка, Врадіївський р-н, Миколаївська обл., 56341","912","455","889","46","411","46","457","","0","411","46","457","13","444","31","186","6","40","10","32","139","29.10.12"
"480243","132","Миколаївська область","школа, фойє
вул.Леніна, 132Г, с.Сирове, Врадіївський р-н, Миколаївська обл., 56310","1088","550","1063","29","515","23","538","","0","515","23","538","24","514","37","121","48","30","9","53","216","29.10.12"
"480244","132","Миколаївська область","центральна районна лікарня, актова зала
вул.Фрунзе, 2, смт Врадіївка, Врадіївський р-н, Миколаївська обл., 56301","112","82","32","9","23","7","30","","0","23","7","30","1","29","2","10","0","4","0","1","12","28.10.12"
"480377","132","Миколаївська область","будинок культури, актова зала
вул.Горького, 22, с.Багачівка, Кривоозерський р-н, Миколаївська обл., 55152","520","189","514","22","309","22","331","","0","309","22","331","8","323","9","196","2","35","2","4","75","29.10.12"
"480378","132","Миколаївська область","будинок культури, фойє
вул.Садова, 28, с.Миколаївка, Кривоозерський р-н, Миколаївська обл., 55152","96","28","96","3","65","3","68","","0","65","3","68","3","65","1","46","0","1","0","0","17","29.10.12"
"480379","132","Миколаївська область","школа, спортивна зала
вул.45 років Перемоги, 1, с.Берізки, Кривоозерський р-н, Миколаївська обл., 55114","912","483","899","21","408","21","429","","0","408","21","429","17","412","32","178","1","45","4","24","128","29.10.12"
"480380","132","Миколаївська область","будинок культури, фойє
вул.Молодіжна, 144, с.Бурилове, Кривоозерський р-н, Миколаївська обл., 55150","760","319","758","37","407","34","441","","0","407","34","441","17","424","30","171","3","38","6","12","164","29.10.12"
"480381","132","Миколаївська область","школа, спортивна зала
вул.Голембієвського, 70, с.Велика Мечетня, Кривоозерський р-н, Миколаївська обл., 55130","816","315","817","23","478","23","501","","0","478","23","501","5","496","15","328","2","24","3","11","113","29.10.12"
"480382","132","Миколаївська область","будинок культури, фойє
вул.Центральна, 39, с.Тернувате, Кривоозерський р-н, Миколаївська обл., 55131","248","92","247","13","144","12","156","","0","144","12","156","1","155","4","34","1","18","1","11","86","29.10.12"
"480383","132","Миколаївська область","будинок культури, актова зала
вул.Берегова, 51, с.Токарівка, Кривоозерський р-н, Миколаївська обл., 55130","88","33","85","3","52","3","55","","0","52","3","55","0","55","2","38","2","0","0","3","10","29.10.12"
"480384","132","Миколаївська область","школа, спортивна зала
вул.Центральна, 10В, с.Красненьке, Кривоозерський р-н, Миколаївська обл., 55121","648","253","641","51","349","46","395","","0","349","46","395","10","385","28","216","4","27","2","27","81","29.10.12"
"480385","132","Миколаївська область","районний будинок культури, фойє
майдан Незалежності, 1А, смт Криве Озеро, Кривоозерський р-н, Миколаївська обл., 55104","1144","553","1123","42","552","39","591","","0","552","39","591","20","571","33","243","10","80","4","34","167","29.10.12"
"480386","132","Миколаївська область","аграрний ліцей, фойє, 2-й поверх
вул.Кірова, 11, смт Криве Озеро, Кривоозерський р-н, Миколаївська обл., 55104","944","439","933","21","488","17","505","","0","488","17","505","11","494","36","231","5","42","6","13","161","29.10.12"
"480387","132","Миколаївська область","початкова школа, актова зала
вул.Тельмана, 42, смт Криве Озеро, Кривоозерський р-н, Миколаївська обл., 55104","928","462","933","19","450","16","466","","0","450","16","466","15","451","36","202","5","68","2","28","110","29.10.12"
"480388","132","Миколаївська область","школа №1, фойє
вул.Леніна, 155, смт Криве Озеро, Кривоозерський р-н, Миколаївська обл., 55104","1200","592","1181","15","597","11","608","","0","597","11","608","27","581","39","278","5","58","8","20","173","29.10.12"
"480389","132","Миколаївська область","адмінбудинок ""Райавтодор"", фойє
вул.Поштова, 45, смт Криве Озеро, Кривоозерський р-н, Миколаївська обл., 55104","928","393","927","17","519","16","535","","0","519","16","535","20","515","52","312","7","23","5","23","93","29.10.12"
"480390","132","Миколаївська область","машинолічильна станція, к.2
вул.Свердлова, 1, смт Криве Озеро, Кривоозерський р-н, Миколаївська обл., 55104","856","389","840","8","461","6","467","","0","461","6","467","17","450","51","297","6","16","3","11","66","29.10.12"
"480391","132","Миколаївська область","сільський будинок культури, фойє
вул.Свердлова, 121, смт Криве Озеро, Кривоозерський р-н, Миколаївська обл., 55104","296","113","287","13","172","11","183","","0","172","11","183","11","172","9","93","2","17","0","2","49","29.10.12"
"480392","132","Миколаївська область","будинок культури, к.2
вул.Гагаріна, 87А, с.Секретарка, Кривоозерський р-н, Миколаївська обл., 55142","896","289","891","35","573","34","607","","0","573","34","607","18","589","16","417","36","8","4","13","95","29.10.12"
"480393","132","Миколаївська область","будинок культури, фойє
вул.Садова, 24, с.Криве Озеро Друге, Кривоозерський р-н, Миколаївська обл., 55103","832","428","830","25","383","21","404","","0","383","21","404","21","383","17","185","9","51","1","9","111","29.10.12"
"480394","132","Миколаївська область","будинок культури, фойє
вул.Горького, 311А, с.Криве Озеро Друге, Кривоозерський р-н, Миколаївська обл., 55103","1208","559","1194","34","622","27","649","","0","622","27","649","24","625","46","290","16","72","10","7","184","29.10.12"
"480395","132","Миколаївська область","будинок культури, фойє
вул.Шкільна, 15, с-ще Червоний Орач, Кривоозерський р-н, Миколаївська обл., 55101","136","37","134","7","93","6","99","","0","93","6","99","6","93","10","26","0","7","2","4","44","28.10.12"
"480396","132","Миколаївська область","школа, спортивна зала
вул.Леніна, 60А, с.Курячі Лози, Кривоозерський р-н, Миколаївська обл., 55120","1080","550","1070","53","483","47","530","","0","483","47","530","30","500","34","179","10","94","6","28","149","29.10.12"
"480397","132","Миколаївська область","будинок культури, фойє
вул.1Травня, 7, с.Леніне, Кривоозерський р-н, Миколаївська обл., 55151","432","165","427","23","244","23","267","","0","244","23","267","8","259","14","105","3","39","2","8","88","29.10.12"
"480398","132","Миколаївська область","будинок культури, фойє
вул.Набережна, 72А, с.Луканівка, Кривоозерський р-н, Миколаївська обл., 55113","792","351","784","52","392","49","441","","0","392","49","441","19","422","28","136","6","56","2","29","165","29.10.12"
"480399","132","Миколаївська область","будинок культури, фойє
вул.Щербатого, 40, с.Мазурове, Кривоозерський р-н, Миколаївська обл., 55110","384","150","367","22","213","21","234","","0","213","21","234","5","229","18","87","7","24","6","4","83","29.10.12"
"480400","132","Миколаївська область","школа, фойє
вул.Ткачова, 15, с.Михалкове, Кривоозерський р-н, Миколаївська обл., 55110","176","60","170","21","96","20","116","","0","96","20","116","1","115","7","51","2","20","0","3","32","28.10.12"
"480401","132","Миколаївська область","школа, спортивна зала
вул.Леніна, 1, с.Мала Мечетня, Кривоозерський р-н, Миколаївська обл., 55122","488","188","489","34","267","33","300","","0","267","33","300","9","291","13","156","3","22","0","18","79","28.10.12"
"480402","132","Миколаївська область","будинок культури, фойє
вул.Центральна, 34, с.Ониськове, Кривоозерський р-н, Миколаївська обл., 55123","656","258","640","39","364","34","398","","0","364","34","398","15","383","27","158","5","44","3","45","101","29.10.12"
"480403","132","Миколаївська область","будинок культури, фойє
вул.Космонавтів, 28, с.Очеретня, Кривоозерський р-н, Миколаївська обл., 55111","552","143","540","55","357","52","409","","0","357","52","409","11","398","21","144","8","23","3","11","188","29.10.12"
"480404","132","Миколаївська область","будинок культури, фойє
вул.Леніна, 103, с.Тридуби, Кривоозерський р-н, Миколаївська обл., 55140","672","279","671","21","372","21","393","","0","372","21","393","7","386","22","172","1","50","1","6","134","29.10.12"
"480405","132","Миколаївська область","школа, їдальня
вул.1Травня, 47, с.Тридуби, Кривоозерський р-н, Миколаївська обл., 55140","776","376","765","31","370","30","400","","0","370","30","400","15","385","17","157","3","68","3","7","130","29.10.12"
"480406","132","Миколаївська область","ЦРЛ, к.2
вул.Шевченка, 59, смт Криве Озеро, Кривоозерський р-н, Миколаївська обл., 55104","136","90","46","0","46","0","46","","0","46","0","46","0","46","1","7","0","3","0","0","35","28.10.12"
"480553","132","Миколаївська область","селищна рада, фойє
вул.Комсомольська, 12А, смт Підгородна, Первомайський р-н, Миколаївська обл., 55222","1720","843","1697","81","814","63","877","","0","814","63","877","29","848","43","219","58","12","13","115","388","28.10.12"
"480554","132","Миколаївська область","сільська рада, фойє
вул.Радянська, 16, с.Болеславчик, Первомайський р-н, Миколаївська обл., 55220","360","144","352","31","189","27","216","","0","189","27","216","11","205","24","56","3","22","3","24","73","28.10.12"
"480555","132","Миколаївська область","школа, фойє
вул.Шкільна, 6, с.Станіславчик, Первомайський р-н, Миколаївська обл., 55221","368","128","362","37","204","36","240","","0","204","36","240","11","229","28","44","3","30","6","19","99","28.10.12"
"480556","132","Миколаївська область","школа, фойє
вул.Революції, 59, с.Грушівка, Первомайський р-н, Миколаївська обл., 55225","880","411","868","57","420","49","469","","0","420","49","469","16","453","32","167","6","28","4","65","151","29.10.12"
"480557","132","Миколаївська область","школа, фойє
вул.Шкільна, 4, с.Кінецьпіль, Первомайський р-н, Миколаївська обл., 55230","2136","1544","1300","35","562","30","592","","0","562","30","592","12","580","18","416","4","24","0","18","100","29.10.12"
"480558","132","Миколаївська область","школа, перше крило, фойє
вул.Шкільна, 4, с.Кінецьпіль, Первомайський р-н, Миколаївська обл., 55230","1344","685","1333","26","638","21","659","","0","638","21","659","16","643","14","483","15","0","1","25","105","29.10.12"
"480559","132","Миколаївська область","школа, фойє
вул.Леніна, 45, с.Кам’яний Міст, Первомайський р-н, Миколаївська обл., 55232","824","375","813","43","410","39","449","","0","410","39","449","16","433","43","157","8","40","11","40","134","29.10.12"
"480560","132","Миколаївська область","сільський клуб, актовий зал
вул.П.Гречаного, 21, с.Кримка, Первомайський р-н, Миколаївська обл., 55261","920","382","902","30","509","29","538","","0","509","29","538","14","524","28","345","3","14","3","28","103","29.10.12"
"480561","132","Миколаївська область","школа, фойє
вул.Центральна, 116, с.Кумарі, Первомайський р-н, Миколаївська обл., 55260","816","304","815","95","422","90","512","","0","422","90","512","12","500","27","325","8","29","4","12","95","29.10.12"
"480562","132","Миколаївська область","дитячий садок, актовий зал
вул.Велика, 55, с.Лиса Гора, Первомайський р-н, Миколаївська обл., 55250","640","287","633","51","305","48","353","","0","305","48","353","14","339","25","81","4","17","6","16","190","29.10.12"
"480563","132","Миколаївська область","школа №3, фойє
вул.Вахненка, 7, с.Лиса Гора, Первомайський р-н, Миколаївська обл., 55250","640","294","626","55","292","54","346","","0","292","54","346","14","332","34","103","6","21","10","39","119","29.10.12"
"480564","132","Миколаївська область","будинок культури, актовий зал
пров.Комсомольський, 2, с.Лиса Гора, Первомайський р-н, Миколаївська обл., 55250","904","376","897","54","479","49","528","","0","479","49","528","18","510","36","185","14","38","25","29","183","29.10.12"
"480565","132","Миколаївська область","будинок культури, актовий зал
вул.Шевченка, 45/1, с.Лиса Гора, Первомайський р-н, Миколаївська обл., 55250","712","343","703","60","312","57","369","","0","312","57","369","9","360","24","114","10","22","8","40","142","29.10.12"
"480566","132","Миколаївська область","навчально-виховний комплекс, актовий зал
вул.Садова, 4, с.Лукашівка, Первомайський р-н, Миколаївська обл., 55242","472","196","467","31","248","28","276","","0","248","28","276","12","264","29","107","6","3","3","24","92","29.10.12"
"480567","132","Миколаївська область","сільський клуб, зал
вул.Миру, 1А, с.Чаусове Друге, Первомайський р-н, Миколаївська обл., 55235","448","114","433","41","295","39","334","","0","295","39","334","4","330","10","277","2","3","1","8","29","29.10.12"
"480568","132","Миколаївська область","сільський клуб, фойє
вул.Первомайська, 41, с.Мигія, Первомайський р-н, Миколаївська обл., 55223","1696","800","1677","31","868","28","896","","0","868","28","896","43","853","64","373","9","80","8","56","263","29.10.12"
"480569","132","Миколаївська область","сільський клуб, фойє
вул.Лісова, 6, с.Куріпчине, Первомайський р-н, Миколаївська обл., 55223","96","44","89","5","49","3","52","","0","49","3","52","2","50","3","29","1","1","0","2","14","29.10.12"
"480570","132","Миколаївська область","школа-сад, фойє
вул.Набережна, 88, с.Підгір’я, Первомайський р-н, Миколаївська обл., 55236","200","78","193","19","107","15","122","","0","107","15","122","3","119","7","47","2","7","2","4","50","29.10.12"
"480571","132","Миколаївська область","ПрАТ ""Підгур’ївське"", актовий зал
вул.Центральна, 14, с.Мічуріне, Первомайський р-н, Миколаївська обл., 55237","232","60","229","13","162","10","172","","0","162","10","172","1","171","21","58","2","3","2","11","74","29.10.12"
"480572","132","Миколаївська область","сільський клуб, фойє
вул.Шевченка, 19, с.Полтавка, Первомайський р-н, Миколаївська обл., 55264","368","127","368","28","214","27","241","","0","214","27","241","13","228","50","87","0","21","2","9","59","29.10.12"
"480573","132","Миколаївська область","сільський клуб, фойє
вул.Шевченка, 35, с.Старі Кошари, Первомайський р-н, Миколаївська обл., 55264","192","72","186","20","101","19","120","","0","101","19","120","10","110","12","35","0","16","2","4","41","29.10.12"
"480574","132","Миколаївська область","ФГ ""Основа"", фойє
вул.Генерала Богданова, 28, с.Романова Балка, Первомайський р-н, Миколаївська обл., 55270","552","134","547","31","388","30","418","","0","388","30","418","10","408","29","79","2","22","1","33","242","28.10.12"
"480575","132","Миколаївська область","бібліотека, читальний зал
вул.Трудової Слави, 26, с-ще Іванівка, Первомайський р-н, Миколаївська обл., 55272","296","131","291","7","160","5","165","","0","160","5","165","10","155","20","59","4","21","3","21","27","29.10.12"
"480576","132","Миколаївська область","сільський клуб, фойє
вул.Первомайська, 1, с.Соколівка, Первомайський р-н, Миколаївська обл., 55270","112","37","107","11","66","9","75","","0","66","9","75","3","72","8","25","1","8","0","9","21","29.10.12"
"480577","132","Миколаївська область","сільський клуб, фойє
вул.Садова, 10, с.Генівка, Первомайський р-н, Миколаївська обл., 55271","192","62","188","7","123","7","130","","0","123","7","130","2","128","7","39","4","8","1","11","58","29.10.12"
"480578","132","Миколаївська область","школа, актовий зал
вул.Шкільна, 13А, с.Синюхин Брід, Первомайський р-н, Миколаївська обл., 55243","1168","570","1151","71","540","58","598","","0","540","58","598","26","572","98","212","11","31","8","90","122","29.10.12"
"480579","132","Миколаївська область","школа, фойє
вул.Первомайська, 5, с.Степківка, Первомайський р-н, Миколаївська обл., 55274","784","325","770","47","417","42","459","","0","417","42","459","16","443","31","229","7","17","4","17","138","29.10.12"
"480580","132","Миколаївська область","сільський клуб, фойє
вул.Центральна, 13, с.Жовтневе, Первомайський р-н, Миколаївська обл., 55275","560","229","557","30","304","27","331","","0","304","27","331","5","326","19","108","1","30","3","23","142","29.10.12"
"480581","132","Миколаївська область","школа, фойє
вул.Ювілейна, 20, с.Зелені Кошари, Первомайський р-н, Миколаївська обл., 55276","528","166","528","42","328","34","362","","0","328","34","362","21","341","15","75","4","7","5","28","207","29.10.12"
"480582","132","Миколаївська область","дитячий садок - школа мистецтв, фойє
вул.Радянська, 19, с.Софіївка, Первомайський р-н, Миклаївська обл., 55253","960","515","945","27","424","21","445","","0","424","21","445","11","434","22","165","13","42","17","30","145","29.10.12"
"480583","132","Миколаївська область","навчально-виховний комплекс, фойє
вул.Шкільна, 1, с-ще Бандурка, Первомайський р-н, Миколаївська обл., 55247","608","274","599","39","296","38","334","","0","296","38","334","6","328","22","89","5","29","4","56","123","29.10.12"
"480584","132","Миколаївська область","сільський клуб, фойє
вул.Крижанівського, 49, с.Довга Пристань, Первомайський р-н, Миколаївська обл., 55240","664","225","655","42","400","39","439","","0","400","39","439","14","425","30","164","6","13","2","12","198","29.10.12"
"480585","132","Миколаївська область","сільський клуб, фойє
вул.Центральна, 34, с.Брід, Первомайський р-н, Миколаївська обл., 55241","224","104","210","25","99","21","120","","4","99","21","120","4","116","8","49","1","11","2","7","38","28.10.12"
"480586","132","Миколаївська область","школа, фойє
вул.Центральна, 13, с.Кам’яна Балка, Первомайський р-н, Миколаївська обл., 55233","472","160","469","27","286","26","312","","0","286","26","312","10","302","3","258","0","1","1","3","36","30.10.12"
"480587","132","Миколаївська область","школа, спортивний зал
вул.Шкільна, 1, с-ще Кам’яний Міст, Первомайський р-н, Миколаївська обл., 55231","1080","531","1076","77","481","68","549","","0","481","68","549","9","540","33","274","3","23","0","28","179","29.10.12"
"480588","132","Миколаївська область","школа, актовий зал
вул.Радянська, 1, с.Катеринка, Первомайський р-н, Миколаївська обл., 55263","664","343","652","69","266","55","321","","0","266","55","321","8","313","21","160","6","10","1","20","95","29.10.12"
"480589","132","Миколаївська область","сільський клуб, фойє
вул.Первомайська, 10, с.Тарасівка, Первомайський р-н, Миколаївська обл., 55244","264","93","259","11","161","10","171","","0","161","10","171","2","169","17","67","6","4","4","5","66","29.10.12"
"480590","132","Миколаївська область","сільський клуб, фойє
вул.Степова, 3А, с.Лозуватка, Первомайський р-н, Миколаївська обл., 55244","144","62","138","6","77","5","82","","0","77","5","82","2","80","8","22","0","11","0","5","34","29.10.12"
"480591","132","Миколаївська область","сільський клуб, фойє
вул.Київська, 86, с.Бандурка, Первомайський р-н, Миколаївська обл., 55247","160","63","156","7","90","7","97","","0","90","7","97","4","93","12","22","1","9","4","10","35","29.10.12"
"480592","132","Миколаївська область","сільський клуб, фойє
вул.50-річчя Жовтня, 50, с-ще Новоолександрівка, Первомайський р-н, Миколаївська обл., 55244","104","43","97","18","47","14","61","","0","47","14","61","4","57","3","28","1","3","0","3","19","29.10.12"
"480593","132","Миколаївська область","сільський клуб, фойє
вул.Антонова, 9, с.Чаусове, Первомайський р-н, Миколаївська обл., 55234","472","182","470","20","271","19","290","","0","271","19","290","9","281","14","144","4","11","4","17","87","29.10.12"
"480674","132","Миколаївська область","гімназія, актова зала
вул.Дзержинського, 20, м.Первомайськ, Миколаївська обл., 55200","2040","1000","1995","42","1005","35","1040","","0","1005","35","1040","19","1021","81","527","5","7","9","32","360","29.10.12"
"480675","132","Миколаївська область","будинок культури, фойє
вул.Грушевського, 1, м.Первомайськ, Миколаївська обл., 55200","1768","826","1736","32","916","26","942","","0","916","26","942","28","914","63","428","9","8","11","12","383","29.10.12"
"480676","132","Миколаївська область","медичне училище, актова зала
вул.Грушевського, 50, м.Первомайськ, Миколаївської обл., 55200","768","396","762","13","359","13","372","","0","359","13","372","10","362","35","205","1","10","4","2","105","29.10.12"
"480677","132","Миколаївська область","Первомайський РЕМ, актова зала
вул.Пушкіна, 5, м.Первомайськ, Миколаївської обл., 55200","1008","591","1011","14","405","12","417","","0","405","12","417","13","404","21","213","1","6","3","15","145","29.10.12"
"480678","132","Миколаївська область","школа №1, спортивна зала
вул.Лейтенанта Шмідта, 25, м.Первомайськ, Миколаївська обл., 55200","1000","537","989","21","444","19","463","","0","444","19","463","11","452","33","236","3","7","2","8","163","29.10.12"
"480679","132","Миколаївська область","Одеський університет імені І.І.Мечникова, актова зала
вул.40 років Перемоги, 4, м.Первомайськ, Миколаївська обл., 55200","2224","1132","2197","22","1078","14","1092","","0","1078","14","1092","30","1062","57","365","5","16","7","40","572","29.10.12"
"480680","132","Миколаївська область","АТВТ ""Первомайсьдизельмаш"", їдальня
вул.Гагаріна, 17, м.Первомайськ, Миколаївська обл., 55200","2248","1208","2235","28","1015","25","1040","","0","1015","25","1040","36","1004","79","466","5","8","8","12","426","29.10.12"
"480681","132","Миколаївська область","школа №3, спортивна зала
вул.Урицького, 155, м.Первомайськ, Миколаївська обл., 55200","1880","1108","1848","38","738","34","772","","0","738","34","772","30","742","78","306","7","9","6","4","332","29.10.12"
"480682","132","Миколаївська область","школа №7, спортивна зала
вул.1 Травня, 37, м.Первомайськ, Миколаївська обл., 55200","1832","1001","1819","24","811","20","831","","0","811","20","831","25","806","63","433","2","23","11","5","269","29.10.12"
"480683","132","Миколаївська область","школа №16, спортивна зала
вул.Одеська, 109, м.Первомайськ, Миколаївська обл., 55200","2112","1125","2101","10","978","9","987","","0","978","9","987","33","954","51","412","6","4","7","36","438","29.10.12"
"480684","132","Миколаївська область","школа №16, актова зала
вул.Одеська, 109, м.Первомайськ, Миколаївська обл., 55200","1808","1006","1781","16","789","13","802","","0","789","13","802","28","774","40","301","4","3","7","7","412","29.10.12"
"480685","132","Миколаївська область","школа №8, спортивна зала
вул.20 років Жовтня, 103, м.Первомайськ, Миколаївська обл., 55200","1704","929","1702","51","732","43","775","","0","732","43","775","14","761","75","310","4","4","7","5","356","29.10.12"
"480686","132","Миколаївська область","школа №9, фойє
вул.Юності, 1, м.Первомайськ, Миколаївська обл., 55200","1216","726","1201","25","471","19","490","","0","471","19","490","15","475","23","258","5","23","4","7","155","29.10.12"
"480687","132","Миколаївська область","школа №9, актова зала
вул.Юності, 1, м.Первомайськ, Миколаївська обл., 55200","1432","728","1416","31","678","26","704","","0","678","26","704","14","690","41","347","2","2","3","22","273","29.10.12"
"480688","132","Миколаївська область","спеціальна школа-інтернат, спортивна зала
вул.Червонофлотська, 25, м.Первомайськ, Миколаївська обл., 55200","1680","913","1644","44","731","36","767","","0","731","36","767","27","740","45","365","9","3","5","33","280","29.10.12"
"480689","132","Миколаївська область","приватний будинок, к.2
вул.З.Космодем’янської, 55Б, м.Первомайськ, Миколаївська обл., 55200","1312","809","1302","62","457","46","503","","0","457","46","503","22","481","65","231","4","9","7","9","156","29.10.12"
"480690","132","Миколаївська область","школа №17, фойє
вул.Шолом Алейхема, 56, м.Первомайськ, Миколаївська обл., 55200","1984","1017","1961","56","924","43","967","","0","924","43","967","32","935","77","427","8","1","10","16","396","29.10.12"
"480691","132","Миколаївська область","школа-сад №14, актова зала
вул.Поповича, 60, м.Первомайськ, Миколаївська обл., 55200","544","272","537","19","253","19","272","","0","253","19","272","5","267","7","80","3","18","4","3","152","29.10.12"
"480692","132","Миколаївська область","ВАТ ПМК 226, їдальня
вул.9 Січня, 78, м.Первомайськ, Миколаївська обл., 55200","1424","778","1403","40","609","37","646","","0","609","37","646","14","632","51","308","0","22","9","58","184","29.10.12"
"480693","132","Миколаївська область","школа №12, спортивна зала
вул.Чкалова, 19, м.Первомайськ, Миколаївська обл., 55200","1328","761","1313","44","541","26","567","","0","541","26","567","17","550","40","282","5","30","5","3","185","29.10.12"
"480694","132","Миколаївська область","школа №12, фойє
вул.Чкалова, 19, м.Первомайськ, Миколаївська обл., 55200","768","408","774","17","344","16","360","","0","344","16","360","12","348","35","178","1","8","2","5","119","29.10.12"
"480695","132","Миколаївська область","міська лікарня, актова зала
вул.Трудової Слави, 13, м.Первомайськ, Миколаївська обл., 55200","2056","1126","2035","55","883","47","930","","0","883","47","930","44","886","98","359","4","39","10","45","331","29.10.12"
"480696","132","Миколаївська область","школа №4, актова зала
вул.Київська, 76, м.Первомайськ, Миколаївська обл., 55200","1872","1004","1838","25","844","24","868","","0","844","24","868","34","834","83","311","13","38","6","23","360","29.10.12"
"480697","132","Миколаївська область","ВАТ ""Первомайськавтотранс"", актова зала
вул.Загородня, 48, м.Первомайськ, Миколаївська обл., 55200","2216","1215","2182","48","962","39","1001","","0","962","39","1001","38","963","88","500","4","2","14","35","320","29.10.12"
"480698","132","Миколаївська область","АТЗТ ""Санта-Україна"", будинок культури
вул.Андрія Чернецького, 108, м.Первомайськ, Миколаївська обл., 55200","1432","781","1415","21","636","15","651","","0","636","15","651","23","628","66","275","1","32","6","21","227","29.10.12"
"480699","132","Миколаївська область","школа №6, спортивна зала
вул.П.Тичини, 50, м.Первомайськ, Миколаївська обл., 55200","1328","732","1318","30","567","29","596","","0","567","29","596","19","577","69","230","5","26","8","18","221","29.10.12"
"480700","132","Миколаївська область","дитячий навчальний заклад №13, актова зала
вул.Комінтерна, 26, м.Первомайськ, Миколаївська обл., 55200","1456","829","1441","28","605","22","627","","0","605","22","627","13","614","71","278","7","20","3","8","227","30.10.12"
"480701","132","Миколаївська область","ПТУ №22, актова зала
вул.Корабельна, 20/2, м.Первомайськ, Миколаївська обл., 55200","2144","1246","2091","20","884","14","898","","0","884","14","898","24","874","71","459","3","23","4","18","296","29.10.12"
"480702","132","Миколаївська область","школа №5, фойє
вул.Корабельна, 4А, м.Первомайськ, Миколаївська обл., 55200","2256","1268","2203","13","979","9","988","","0","979","9","988","28","960","63","451","6","55","5","28","352","29.10.12"
"480703","132","Миколаївська область","БКіТ ""Фрегат"", фойє
вул.Корабельна, м.Первомайськ, Миколаївська обл., 55200","2376","1107","2352","27","1255","14","1269","","0","1255","14","1269","48","1221","126","626","6","63","9","23","368","29.10.12"
"480704","132","Миколаївська область","школа №15, актова зала
вул.Коротченка, 18, м.Первомайськ, Миколаївська обл., 55200","2448","1231","2407","11","1208","9","1217","","0","1208","9","1217","36","1181","57","462","4","85","8","50","515","29.10.12"
"480705","132","Миколаївська область","школа №15, спортивна зала
вул.Коротченка, 18, м.Первомайськ, Миколаївська обл., 55200","2448","1165","2452","18","1268","15","1283","","0","1268","15","1283","22","1261","88","331","15","116","23","16","672","29.10.12"
"480706","132","Миколаївська область","""Комунбудтехсервіс"", актова зала
вул.Достоєвського, 14, м.Первомайськ, Миколаївська обл., 55200","2504","1322","2473","15","1171","11","1182","","0","1171","11","1182","18","1164","45","448","4","45","5","223","394","29.10.12"
"480707","132","Миколаївська область","міська лікарня, дитяче відділення
вул.Толбухіна, 17, м.Первомайськ, Миколаївська обл., 55200","56","39","27","19","3","14","17","","0","3","14","17","0","17","5","5","0","2","0","2","3","29.10.12"
"480708","132","Миколаївська область","пологовий будинок, к.1
вул.Червонофлотська, 43, м.Первомайськ, Миколаївська обл., 55200","32","15","17","1","16","1","17","","0","16","1","17","0","17","2","9","0","1","0","1","4","29.10.12"
"480709","132","Миколаївська область","первомайська районна лікарня, актова зала
вул.Луначарського, 28А, м.Первомайськ, Миколаївська обл., 55200","64","39","28","22","5","20","25","","0","5","20","25","0","25","2","11","0","3","1","3","5","29.10.12"
