"№ ВД","OBO","Назва регіону України","Місцезнаходження та адреса приміщення для голосування","1) К-сть одержаних бюлетенів","2) К-сть невикористаних бюлетенів","3) К-сть виборців, внесених до списку виборців","4) К-сть виборців, внесених до витягу зі списку виборців","5) К-сть виборців, які отримали бюлетені у приміщенні","6) К-сть виборців, які отримали за місцем перебування","7) Сумарна к-сть виборців, які отримали бюлетені","8) К-сть бюлетенів, що виявилися у кожній скринці","9) К-сть бюлетенів, що не підлягають врахуванню","10) К-сть виборців, які взяли участь у голос. у приміщенні для гол.","11) К-сть виборців, які взяли участь у голос. за місцем перебування","12) К-сть виборців, які взяли участь у голосуванні на виборчій дільниці","13) К-сть бюлетенів, визнаних недійсними","14) Сумарна к-сть голосів виборців ЗА","Барнацький
Павло
Степанович","Возняк
Віктор
Франкович","Гентош
Тарас
Йосифович","Грабовський
Святослав
Мирославович","Гук
Микола
Петрович","Задорожний
Іван
Маркович","Задорожний
Михайло
Леонович","Зубицька
Наталія
Петрівна","Ілик
Роман
Романович","Конц
Віктор
Ярославович","Курус
Ігор
Федорович","Курчик
Тарас
Михайлович","Лагодич
Микола
Миколайович","Одрехівський
Микола
Васильович","Сендак
Михайло
Дмитрович","Соколов
Віктор
Михайлович","Старовойтова
Валентина
Михайлівна","Трощановський
Костянтин
Анатолійович","Тустановський
Микола
Миронович","Янковський
Михайло
Петрович","Дата підписання протоколу"
"000006","121","Львівська область","
вул. Шевченка, 300, смт Східниця, м. Борислав, Львівська обл., 82391","80","50","36","0","30","0","30","","0","30","0","30","1","29","0","0","1","0","0","0","0","1","7","0","1","0","1","0","0","0","1","0","0","17","29.10.12"
"460223","121","Львівська область","народний дім, к.1
вул.І.Франка, 121, с.Бистриця, Дрогобицький р-н, Львівської обл., 82122","328","86","325","21","221","21","242","","0","221","21","242","7","235","4","2","0","0","8","8","25","3","110","1","37","1","23","0","1","0","0","0","0","12","29.10.12"
"460224","121","Львівська область","народний дім, к.1
вул.Залужна, 48, с.Биків, Дрогобицький р-н, Львівської обл., 82122","216","53","216","4","159","4","163","","0","159","4","163","5","158","3","0","1","2","6","3","17","3","71","1","11","3","24","1","0","1","0","1","0","10","29.10.12"
"460225","121","Львівська область","школа, к.1
вул.Шкільна, 7, с.Болехівці, Дрогобицький р-н, Львівська обл., 82170","1272","306","1268","78","890","76","966","","0","890","76","966","17","949","25","25","1","2","11","32","313","7","396","12","44","24","24","9","4","0","1","3","1","15","29.10.12"
"460226","121","Львівська область","народний дім, к.2
вул.Самбірська, 6, с.Брониця, Дрогобицький р-н, Львівська обл., 82120","664","206","670","59","399","59","458","","0","399","59","458","2","456","13","3","3","0","29","5","40","4","278","9","19","8","12","8","5","1","0","0","3","16","29.10.12"
"460227","121","Львівська область","народний дім, к.2
вул.Ювілейна, 75, с.Бистриця (Гірська), Дрогобицький р-н, Львівська обл., 82190","220","81","221","23","117","22","139","","0","117","22","139","5","134","16","0","0","1","0","2","5","1","74","5","9","1","1","0","17","0","0","0","0","2","29.10.12"
"460228","121","Львівська область","школа, к.3
вул.Дрогобицька, 19, с.Волоща, Дрогобицький р-н, Львівська обл., 82130","940","243","934","37","660","37","697","","0","660","37","697","17","680","35","34","0","0","10","39","268","1","215","6","16","1","3","2","7","0","0","1","0","42","29.10.12"
"460229","121","Львівська область","народний дім, к.1
вул.Волянська, 110, с.Воля Якубова, Дрогобицький р-н, Львівська обл., 82134","244","58","246","27","160","26","186","","0","160","26","186","3","183","5","1","0","0","4","5","30","1","107","2","9","0","0","1","2","1","0","0","0","15","29.10.12"
"460230","121","Львівська область","народний дім, к.2
вул.Тараса Шевченка, 23, с.Верхній Дорожів, Дрогобицький р-н, Львівська обл., 82131","1148","356","1150","114","685","107","792","","0","685","107","792","13","779","67","7","3","1","38","7","76","21","428","8","61","13","17","3","5","1","1","3","1","18","29.10.12"
"460231","121","Львівська область","народний дім, к.2
вул.Кармелюка, народний дім, с.Винники, Дрогобицький р-н, Львівська обл., 82125","620","177","606","52","391","52","443","","0","391","52","443","7","436","28","6","0","2","26","11","32","8","219","13","32","8","41","0","4","2","0","0","0","4","29.10.12"
"460232","121","Львівська область","народний дім, к.2
вул.30 річчя Перемоги, народний дім, с.Вороблевичі, Дрогобицький р-н, Львівська обл., 82150","804","240","805","45","519","45","564","","0","519","45","564","13","551","33","7","2","1","13","21","91","10","252","14","47","31","4","6","4","1","2","1","0","11","29.10.12"
"460233","121","Львівська область","школа, к.6
вул.30 річчя Перемоги, школа, с.Вороблевичі, Дрогобицький р-н, Львівська обл., 82150","628","182","618","35","411","35","446","","0","411","35","446","31","415","31","5","0","0","12","12","47","1","217","8","23","28","3","3","5","2","0","0","3","15","29.10.12"
"460234","121","Львівська область","школа, к.3
вул.Грушевського, 44, с.Грушів (Красне), Дрогобицький р-н, Львівська обл., 82132","872","230","877","19","623","19","642","","0","623","19","642","23","619","23","1","2","0","45","18","62","9","321","37","50","9","4","2","7","1","2","0","1","25","29.10.12"
"460235","121","Львівська область","школа, к.2
вул.Миру, 93, с.Грушів (Старе), Дрогобицький р-н, Львівська обл., 82132","712","246","713","34","434","32","466","","0","434","32","466","6","460","23","2","3","4","20","11","54","9","246","25","20","6","11","2","8","1","0","1","1","13","29.10.12"
"460236","121","Львівська область","народний дім, к.2
вул.Стуса, 2, с.Городківка, Дрогобицький р-н, Львівська обл., 82133","120","12","128","12","96","12","108","","0","96","12","108","2","106","0","0","1","1","2","2","15","0","65","2","10","6","0","0","0","0","0","0","0","2","29.10.12"
"460237","121","Львівська область","школа, к.26
вул.Стебницька, 18, с.Доброгостів, Дрогобицький р-н, Львівська обл., 82176","1332","534","1334","23","775","23","798","","0","775","23","798","12","786","12","3","10","1","28","19","121","2","369","58","84","8","54","0","2","0","2","0","4","9","29.10.12"
"460238","121","Львівська область","народний дім, к.2
вул.1 Травня, 11, с.Доброгостів, Дрогобицький р-н, Львівська обл., 82176","1336","528","1330","16","793","15","808","","0","793","15","808","22","786","15","4","4","0","23","26","95","5","385","47","101","15","41","0","5","0","0","1","1","18","29.10.12"
"460239","121","Львівська область","навчально виховний комплекс, к.2
вул.Шкільна, 14, с.Добрівляни, Дрогобицький р-н, Львівська обл., 82134","900","267","883","53","580","53","633","","0","580","53","633","12","621","17","9","8","1","32","10","70","5","352","9","68","6","7","1","3","0","2","1","2","18","29.10.12"
"460240","121","Львівська область","сільська рада, к.3
вул.Молодіжна, 73, с.Дережичі, Дрогобицький р-н, Львівська обл., 82185","1088","334","1080","19","735","19","754","","0","735","19","754","17","737","75","29","9","0","28","15","96","10","327","27","62","9","12","3","13","2","1","0","5","14","29.10.12"
"460241","121","Львівська область","школа, к.1
вул.Шевченка, 1, с.Довге Гірське, Дрогобицький р-н, Львівська обл., 82195","632","259","633","40","333","40","373","","0","333","40","373","10","363","203","1","0","1","0","0","4","1","92","1","11","3","26","1","3","1","0","0","0","15","29.10.12"
"460242","121","Львівська область","школа, к.1
вул.Л.Українки, 165, с.Долішній Лужок, Дрогобицький р-н, Львівська обл., 82121","528","123","522","42","364","41","405","","0","364","41","405","9","396","26","3","6","1","36","8","28","7","192","6","51","4","9","0","4","0","1","1","0","13","29.10.12"
"460243","121","Львівська область","народний дім, к.2
вул.Шкільна, 10, с.Далява, Дрогобицький р-н, Львівська обл., 82166","288","95","297","34","159","34","193","","0","159","34","193","7","186","10","7","1","1","5","5","41","3","78","2","15","1","0","2","2","0","1","0","0","12","29.10.12"
"460244","121","Львівська область","народний дім, к.1
вул.Шевченка, 41А, с.Жданівка, Дрогобицький р-н, Львівська обл., 82190","120","44","121","9","67","9","76","","0","67","9","76","1","75","1","0","1","0","3","0","3","0","10","1","5","1","1","0","41","1","0","2","3","2","29.10.12"
"460245","121","Львівська область","народний дім, к.2
вул.Миру, 122, с.Залокоть, Дрогобицький р-н, Львівська обл., 82192","844","262","840","53","532","50","582","","0","532","50","582","14","568","49","3","1","0","49","8","48","0","290","10","39","28","18","0","20","0","1","0","1","3","29.10.12"
"460246","121","Львівська область","школа, к.3
вул.Верховини, 105, с.Залужани, Дрогобицький р-н, Львівська обл., 82152","620","170","620","36","414","36","450","","0","414","36","450","12","438","56","4","3","0","3","6","51","7","219","18","25","8","17","1","2","0","1","0","1","16","29.10.12"
"460247","121","Львівська область","народний дім, к.2
вул.І.Франка, 135, с.Нагуєвичі, Дрогобицький р-н, Львівська обл., 82126","1752","536","1741","130","1086","130","1216","","0","1086","130","1216","21","1195","108","44","5","2","109","16","129","15","535","33","74","27","14","8","14","1","2","1","1","57","29.10.12"
"460248","121","Львівська область","народний дім, к.1
вул.Зелена, 31, с.Котоване, Дрогобицький р-н, Львівська обл., 82123","76","10","80","7","59","7","66","","0","59","7","66","1","65","4","1","0","1","2","1","4","1","15","2","18","7","0","0","1","0","0","0","0","8","29.10.12"
"460249","121","Львівська область","народний дім, к.2
вул.Кобилянської, 1, с.Літиня, Дрогобицький р-н, Львівська обл., 82133","672","70","675","56","546","56","602","","0","546","56","602","11","591","33","8","2","4","29","7","46","5","391","14","23","8","4","0","1","0","0","2","2","12","29.10.12"
"460250","121","Львівська область","школа, к.3
вул.І.Франка, 2, с.Лішня, Дрогобицький р-н, Львівська обл., 82127","1956","588","1940","39","1329","39","1368","","0","1329","39","1368","12","1356","39","27","5","1","425","12","68","12","539","79","45","9","27","7","32","1","2","1","2","23","29.10.12"
"460251","121","Львівська область","народний дім, к.1
вул.Шевченка, 51А, с.Майдан, Дрогобицький р-н, Львівська обл., 82195","300","120","297","18","162","18","180","","0","162","18","180","9","171","32","2","0","0","3","4","18","2","60","3","14","3","5","1","11","0","0","2","1","10","29.10.12"
"460252","121","Львівська область","народний дім, к.2
вул.Долішня, 1, с.Медвежа, Дрогобицький р-н, Львівська обл., 82129","600","135","595","40","426","39","465","","0","426","39","465","7","458","12","8","1","0","30","11","35","2","282","15","28","5","4","1","0","0","0","0","1","23","29.10.12"
"460253","121","Львівська область","народний дім, к.2
вул.Дрогобицька, 17, с.Михайлевичі, Дрогобицький р-н, Львівська обл., 82153","740","158","736","27","557","25","582","","0","557","25","582","14","568","65","10","1","2","8","8","46","0","292","32","28","7","57","1","0","0","1","0","1","9","29.10.12"
"460254","121","Львівська область","навчально виховний комплекс, к.2
вул.Шкільна, 6, с.Модричі, Дрогобицький р-н, Львівська обл., 82186","996","330","994","27","642","24","666","","0","642","24","666","15","651","51","9","33","0","17","9","60","5","354","8","32","9","34","1","6","1","1","0","4","17","29.10.12"
"460255","121","Львівська область","школа, к.2
вул.Шевченка, 15А, с.Мокряни, Дрогобицький р-н, Львівська обл., 82125","296","72","305","26","198","26","224","","0","198","26","224","6","218","20","3","3","0","7","5","12","2","110","2","13","3","17","0","3","0","0","0","0","18","29.10.12"
"460256","121","Львівська область","школа, к.3
вул.Медвежанська, 53, с.Монастир-Лішнянський, Дрогобицький р-н, Львівська обл., 82127","232","44","241","7","181","7","188","","0","181","7","188","0","188","2","3","3","0","33","1","10","0","118","1","6","0","2","1","1","0","1","0","0","6","29.10.12"
"460257","121","Львівська область","народний дім, к.2
вул.Довбуша, 160, с.Новий Кропивник, Дрогобицький р-н, Львівська обл., 82194","1052","374","1039","73","610","68","678","","0","610","68","678","12","666","256","4","10","2","17","11","33","17","166","9","44","12","25","10","15","1","9","9","3","13","29.10.12"
"460258","121","Львівська область","народний дім, к.1
вул.Шевченка, 110, с.Новошичі, Дрогобицький р-н, Львівська обл., 82122","388","104","391","18","266","18","284","","0","266","18","284","5","279","8","1","0","0","13","2","10","3","147","8","30","1","41","2","5","0","1","0","0","7","29.10.12"
"460259","121","Львівська область","народний дім, к.3
вул.Шевченка, 241А, с.Опака, Дрогобицький р-н, Львівська обл., 82191","1376","586","1370","70","720","70","790","","0","720","70","790","24","766","174","1","5","1","38","3","19","4","349","13","44","6","14","10","62","0","5","1","3","14","29.10.12"
"460260","121","Львівська область","школа, к.1
вул.Зарічна, 4, с.Ортиничі, Дрогобицький р-н, Львівська обл., 82122","120","47","115","9","64","9","73","","0","64","9","73","1","72","3","0","0","0","0","1","1","1","50","0","2","2","0","2","1","0","0","0","0","9","29.10.12"
"460261","121","Львівська область","народний дім, к.2
вул.Грушевського, 22, смт Підбуж, Дрогобицький р-н, Львівська обл., 82180","2400","952","2371","143","1305","143","1448","","0","1305","143","1448","23","1425","71","29","11","1","42","10","61","21","744","143","74","10","22","3","32","1","7","3","8","132","29.10.12"
"460262","121","Львівська область","народний дім, к.2
вул.Садова, 4А, с.Підмонастирок, Дрогобицький р-н, Львівська обл., 82124","156","45","160","19","92","19","111","","0","92","19","111","2","109","5","0","1","0","1","1","15","3","59","3","9","0","2","0","1","0","0","0","1","8","29.10.12"
"460263","121","Львівська область","школа, к.2
вул.Сонячна, 2, с.Попелі, Дрогобицький р-н, Львівська обл., 82184","1928","734","1921","30","1164","30","1194","","0","1164","30","1194","16","1178","377","7","4","2","14","58","11","13","539","52","39","10","16","3","10","0","2","2","3","16","29.10.12"
"460264","121","Львівська область","народний дім, к.2
вул.Шкільна, 14, с.Почаєвичі, Дрогобицький р-н, Львівська обл., 82167","808","247","798","11","550","11","561","","0","550","11","561","11","550","77","11","9","0","25","14","102","1","212","9","36","6","19","1","7","0","0","1","1","19","30.10.12"
"460265","121","Львівська область","народний дім, к.2
вул.Дрогобицька, 46, с.Раневичі, Дрогобицький р-н, Лвівська обл., 82171","1408","485","1404","23","900","23","923","","0","900","23","923","12","911","43","40","22","1","23","33","161","9","463","7","30","19","37","1","5","3","2","0","0","12","29.10.12"
"460266","121","Львівська область","народний дім, к.2
вул.Тимошенка, 3, с.Рибник, Дрогобицький р-н, Львівська обл., 82195","512","207","499","29","276","29","305","","0","276","29","305","6","299","84","3","0","1","5","4","20","6","112","2","21","4","7","0","5","0","1","1","0","23","29.10.12"
"460267","121","Львівська область","школа, к.2
460267 вул.Шкільна, 7, с.Рихтичі, Дрогобицький р-н, Львівська обл., 82151","1676","600","1676","30","1046","30","1076","","0","1046","30","1076","18","1058","162","36","5","1","32","12","96","13","490","14","64","23","71","9","7","0","5","0","1","17","29.10.12"
"460268","121","Львівська область","народний дім, к.2
вул.Українська, 50, с.Рихтичі, Дрогобицький р-н, Львівська обл., 82151","1044","331","1035","31","682","31","713","","0","682","31","713","17","696","129","25","4","0","13","5","53","7","359","5","22","10","41","11","3","1","1","2","0","5","29.10.12"
"460269","121","Львівська область","народний дім, к.2
вул.Шевченка, 48, с.Ролів, Дрогобицький р-н, Львівська обл., 82135","676","184","671","42","450","42","492","","0","450","42","492","41","451","36","9","3","2","26","9","27","9","256","13","16","5","10","1","8","1","1","2","2","15","29.10.12"
"460270","121","Львівська область","народний дім, к.1
вул.Грушевського, 3, с.Селець, Дрогобицький р-н, Львівська обл., 82123","116","30","120","12","74","12","86","","0","74","12","86","0","86","2","0","1","0","5","1","5","7","40","4","12","1","2","0","0","0","0","1","1","4","29.10.12"
"460271","121","Львівська область","народний дім, к.1
вул.Шевченка, 16А, с.Смільна, Дрогобицький р-н, Львівська обл., 82190","316","123","315","39","156","37","193","","0","156","37","193","1","192","17","1","0","1","3","1","13","1","92","4","11","0","4","1","40","0","0","0","0","3","29.10.12"
"460272","121","Львівська область","народний дім, к.2
вул.Зелена, 71/1, с.Снятинка, Дрогобицький р-н, Львівська обл., 82155","764","205","761","33","527","32","559","","0","527","32","559","13","546","17","6","4","0","18","7","39","10","279","30","47","12","53","4","3","1","1","0","0","15","29.10.12"
"460273","121","Львівська область","народний дім, к.2
вул.Меденицька, 25, с.Солонське, Дрогобицький р-н, Львівська обл., 82166","620","177","613","40","405","38","443","","0","405","38","443","11","432","47","16","4","0","11","13","78","14","116","4","34","14","43","1","6","2","1","0","3","25","29.10.12"
"460274","121","Львівська область","сільська рада, к.2
вул.Грушевського, сільська рада, с.Станиля, Дрогобицький р-н, Львівська обл., 82172","920","193","923","45","684","43","727","","0","684","43","727","23","704","18","22","6","4","29","4","34","14","442","48","48","11","5","3","3","0","0","2","2","9","29.10.12"
"460275","121","Львівська область","школа, к.1
вул.Першотравнева, 47, с.Старий Кропивник, Дрогобицький р-н, Львівська обл., 82193","708","289","700","52","369","50","419","","0","369","50","419","11","408","28","5","6","1","9","14","67","3","141","13","52","8","21","0","19","3","0","2","3","13","29.10.12"
"460276","121","Львівська область","народний дім, к.2
вул.Шевченка, 21, с.Старе Село, Дрогобицький р-н, Львівська обл., 82154","548","130","542","14","404","14","418","","0","404","14","418","12","406","22","11","6","2","23","15","34","7","184","22","35","13","12","4","3","0","0","0","0","13","29.10.12"
"460277","121","Львівська область","народний дім, к.2
вул.Л.Українки, 174, с.Сторона, Дрогобицький р-н, Львівська обл., 82180","1392","556","1391","14","822","14","836","","0","822","14","836","12","824","57","9","12","1","25","12","33","6","458","41","82","9","17","3","15","2","3","2","1","36","29.10.12"
"460278","121","Львівська область","народний дім, к.1
вул.Перемоги, 11, с.Ступниця, Дрогобицький р-н, Львівська обл., 82123","372","128","368","40","204","40","244","","0","204","40","244","6","238","11","5","5","0","8","5","9","1","106","20","49","2","5","0","4","1","0","0","0","7","29.10.12"
"460279","121","Львівська область","школа, к.1
вул.Л.Українки, 46, с.Тинів, Дрогобицький р-н, Львівська обл., 82132","360","99","368","30","231","30","261","","0","231","30","261","7","254","2","1","0","0","1","14","151","2","55","3","9","1","2","0","3","0","1","0","0","9","29.10.12"
"460280","121","Львівська область","сільська рада, к.2
вул.Центральна, 76, с.Уличне, Дрогобицький р-н, Львівська обл., 82177","1312","488","1301","37","789","35","824","","0","789","35","824","15","809","35","12","5","0","56","6","37","15","417","12","173","13","3","1","10","1","0","3","3","7","29.10.12"
"460281","121","Львівська область","школа, к.2
вул.Шкільна, школа, с.Уличне, Дрогобицький р-н, Львівська обл., 82177","1520","565","1521","40","916","39","955","","0","916","39","955","31","924","31","18","10","0","54","9","32","9","479","30","200","15","4","2","14","0","4","0","3","10","29.10.12"
"460282","121","Львівська область","школа, к.3
вул.І.Франка, 50, с.Унятичі, Дрогобицький р-н, Львівська обл., 82128","928","252","921","3","673","3","676","","0","673","3","676","12","664","28","10","5","1","68","6","40","5","306","12","26","5","139","0","0","0","0","0","1","12","30.10.12"
"460283","121","Львівська область","народний дім, к.2
вул.Л.Українки, 88А, с.Уріж, Дрогобицький р-н, Львівська обл., 82124","872","197","864","65","610","65","675","","0","610","65","675","8","667","97","3","2","0","28","16","71","7","326","30","40","8","15","6","4","1","0","0","0","13","29.10.12"
"460284","121","Львівська область","школа, к.2
вул.Шевченка, 12А, с.Ясениця Сільна, Дрогобицький р-н, Львівська обл., 82183","1072","265","1070","68","739","68","807","","0","739","68","807","15","792","58","2","1","1","23","6","21","4","485","65","56","9","45","1","5","0","1","0","7","2","29.10.12"
"460285","121","Львівська область","бібліотека, к.2
вул.Дрогобицька, 55, с.Нове Село, Дрогобицький р-н, Львівська обл., 82170","676","166","678","28","482","28","510","","0","482","28","510","7","503","24","22","3","1","10","15","134","6","211","7","38","7","5","11","0","0","0","0","1","8","29.10.12"
"460286","121","Львівська область","школа, к.2
вул.В.Николяка, школа, с.Бійничі, Дрогобицький р-н, Львівська обл., 82168","208","49","207","13","146","13","159","","0","146","13","159","3","156","10","1","1","0","5","0","25","1","77","4","15","2","0","0","3","1","0","0","0","11","29.10.12"
"460287","121","Львівська область","народний дім, к.2
вул.Залізнична, 2, с.Верхні Гаї, Дрогобицький р-н, Львівська обл., 82169","728","187","726","53","488","53","541","","0","488","53","541","14","527","6","23","3","0","10","15","156","3","221","18","26","9","18","2","4","0","1","0","0","12","29.10.12"
"460288","121","Львівська область","народний дім, к.2
вул.Незалежності, 39, с.Довге, Дрогобицький р-н, Львівська обл., 82196","508","133","507","17","361","14","375","","0","361","14","375","4","371","15","0","1","3","12","14","81","2","135","2","15","3","73","0","1","0","0","0","1","13","30.10.12"
"460289","121","Львівська область","приватний будинок, к.1
вул.1 Травня, 20, с.Коросниця, Дрогобицький р-н, Львівська обл., 82163","108","35","115","0","73","0","73","","0","73","0","73","2","71","2","0","0","1","1","6","25","1","19","1","7","0","0","0","0","0","0","0","1","7","29.10.12"
"460290","121","Львівська область","народний дім, к.3
вул.Б.Хмельницького, 66, с.Летня, Дрогобицький р-н, Львівська обл., 82162","972","314","975","43","616","42","658","","0","616","42","658","14","644","42","11","0","1","29","25","89","3","364","10","33","5","3","1","11","1","3","1","1","11","29.10.12"
"460291","121","Львівська область","школа, к.3
вул.Б.Хмельницького, 6, с.Летня, Дрогобицький р-н, Львівська обл., 82162","1060","294","1053","37","733","33","766","","0","733","33","766","9","757","51","5","3","3","39","15","80","10","437","20","50","6","11","0","6","0","3","2","2","14","29.10.12"
"460292","121","Львівська область","ліцей, к.40
вул.Дрогобицька, 32, смт Меденичі, Дрогобицький р-н, Львівської обл., 82160","1292","450","1272","38","804","38","842","","0","804","38","842","25","817","54","8","8","1","39","19","116","15","426","48","36","3","8","1","11","3","6","2","0","13","29.10.12"
"460293","121","Львівська область","школа, к.20
вул.Шкільна, 3, смт Меденичі, Дрогобицький р-н, Львівська обл., 82160","1244","389","1240","51","804","51","855","","0","804","51","855","26","829","36","10","7","2","37","19","79","10","477","41","52","7","8","1","12","2","4","1","1","23","29.10.12"
"460294","121","Львівська область","школа, к.2
вул.Шкільна, 23, с.Нижні Гаї, Дрогобицький р-н, Львівська обл., 82168","940","294","936","81","568","78","646","","0","568","78","646","6","640","32","14","5","2","23","14","58","9","286","47","96","16","5","0","16","0","2","0","0","15","29.10.12"
"460295","121","Львівська область","народний дім, к.2
вул.Перемоги, 35, с.Опарі, Дрогобицький р-н, Львівська обл., 82164","876","250","878","25","602","24","626","","0","602","24","626","8","618","53","11","5","1","9","13","77","5","308","21","40","5","30","1","14","0","2","2","2","19","29.10.12"
"460296","121","Львівська область","народний дім, к.1
вул.Перемоги, 26, с.Рівне, Дрогобицький р-н, Львівська обл., 82163","140","38","144","5","97","5","102","","0","97","5","102","3","99","3","0","0","0","3","3","16","6","44","2","6","1","0","0","1","2","2","3","0","7","29.10.12"
"460297","121","Львівська область","сільська рада, к.2
вул.Зелена, 3А, с.Ріпчиці, Дрогобицький р-н, Львівська обл., 82165","504","127","503","36","341","36","377","","0","341","36","377","6","371","46","5","3","1","10","12","45","1","177","7","22","8","10","3","2","0","3","0","1","15","29.10.12"
"461685","121","Львівська область","школа №9, кл.1А, 1-й поверх
вул.Дрогобицька, 415, м.Борислав, Львівська обл., 82300","616","225","621","9","385","6","391","","0","385","6","391","12","379","52","3","1","1","14","0","19","3","212","17","15","2","3","3","2","1","3","1","7","20","29.10.12"
"461686","121","Львівська область","ЗОШ № 9, спортивна зала, 1-й поверх
вул.Дрогобицька, 415, м.Борислав, Львівська обл., 82300","848","385","844","25","440","23","463","","0","440","23","463","10","453","90","0","3","2","16","1","14","5","217","30","21","4","6","1","4","0","7","3","5","24","29.10.12"
"461687","121","Львівська область","кінотеатр ""Каменяр"", фойє, 1-й поверх
вул.Шевченка, 25, м.Борислав, Львівська обл., 82300","1416","641","1390","24","752","23","775","","0","752","23","775","21","754","180","3","3","2","36","18","3","15","306","56","42","7","8","1","11","2","13","2","12","34","29.10.12"
"461688","121","Львівська область","школа №8, кабінет інформатики, 1-й поверх
вул.Січових Стрільців, 28, м.Борислав, Львівська обл., 82300","1720","702","1697","15","1003","15","1018","","0","1003","15","1018","14","1004","229","7","8","2","11","7","40","8","503","60","50","6","11","1","10","2","7","2","14","26","30.10.12"
"461689","121","Львівська область","ШБУ №7, актова зала, 1-й поверх
вул.Шухевича, 11, м.Борислав, Львівська обл., 82300","1580","598","1575","31","960","22","982","","0","960","22","982","25","957","244","10","2","4","21","4","38","7","431","48","49","3","27","4","12","0","10","1","11","31","29.10.12"
"461690","121","Львівська область","гуртожиток медичного коледжу, спортивна зала, 1-й поверх
вул.600-річчя Борислава, 14, м.Борислав, Львівська обл., 82300","2404","960","2383","12","1433","11","1444","","0","1433","11","1444","21","1423","439","11","7","2","37","2","8","15","578","111","63","17","21","7","10","1","18","2","43","31","29.10.12"
"461691","121","Львівська область","стоматологічна поліклініка, актова зала, 2-й поверх
вул.С.Коваліва, 42, м.Борислав, Львівська обл., 82300","2120","854","2092","29","1240","26","1266","","0","1240","26","1266","22","1244","354","4","6","4","30","3","15","9","532","102","67","10","22","3","14","1","11","4","28","25","29.10.12"
"461692","121","Львівська область","бібліотека-філіал №6, фойє, 2-й поверх
вул.С.Коваліва, 32, м.Борислав, Львівська обл., 82300","1416","565","1404","6","848","3","851","","0","848","3","851","15","836","186","2","0","1","21","2","14","11","399","65","43","4","18","5","1","2","7","1","34","20","29.10.12"
"461693","121","Львівська область","жіноча консультація, актова зала, 2-й поверх
вул.С.Коваліва, 42, м.Борислав, Львівська обл., 82300","1076","415","1057","9","653","8","661","","0","653","8","661","12","649","156","7","5","0","16","4","12","12","320","34","20","4","10","4","8","0","5","1","18","13","29.10.12"
"461694","121","Львівська область","школа №4, вестибюль, 1-й поверх, ліве крило
вул.Зелена, 44, м.Борислав, Львівська обл., 82300","1764","774","1751","9","981","9","990","","0","981","9","990","23","967","232","9","8","2","33","4","18","20","429","65","35","11","35","2","3","0","17","2","17","25","29.10.12"
"461695","121","Львівська область","школа №4, вестибюль, 1-й поверх, праве крило
вул.Зелена, 44, м.Борислав, Львівська обл., 82300","1688","672","1680","35","985","31","1016","","0","985","31","1016","30","986","249","10","9","3","27","3","18","9","457","55","34","9","10","7","5","3","21","3","21","33","29.10.12"
"461696","121","Львівська область","школа №5, спортивна зала, 1-й поверх
вул.Трускавецька, 124, м.Борислав, Львівська обл., 82300","2048","693","2039","49","1311","44","1355","","0","1311","44","1355","19","1336","222","2","5","0","33","5","22","9","737","100","42","12","21","7","7","1","11","4","73","23","29.10.12"
"461697","121","Львівська область","газове господарство, актова зала, 2-й поверх
вул.Потік, 49, м.Борислав, Львівська обл., 82300","864","345","859","23","497","22","519","","0","497","22","519","15","504","110","0","2","2","24","3","9","7","226","18","50","6","7","4","4","1","1","1","12","17","29.10.12"
"461698","121","Львівська область","палац культури, танцювальна зала, 1-й поверх
вул.Данила Галицького, 34, м.Борислав, Львівська обл., 82300","976","361","973","13","604","11","615","","0","604","11","615","17","598","141","2","4","0","13","2","14","11","246","37","40","6","4","3","4","2","18","1","13","37","29.10.12"
"461699","121","Львівська область","професійний технічний ліцей, вестибюль, 1-й поверх
вул.Героїв ОУН-УПА, 21, м.Борислав, Львівська обл., 82300","784","299","773","14","476","9","485","","0","476","9","485","13","472","104","6","4","0","10","1","7","9","223","33","14","4","3","0","9","0","13","1","6","25","30.10.12"
"461700","121","Львівська область","школа №7, вестибюль, 1-й поверх
вул.Володимира Великого, 14, м.Борислав, Львівська обл., 82300","1060","365","1053","23","677","18","695","","0","677","18","695","15","680","147","11","4","0","24","2","10","12","302","65","41","5","0","0","8","3","8","0","15","23","29.10.12"
"461701","121","Львівська область","будинок школяра, концертна зала, 1-й поверх
вул.Шкільна, 10, м.Борислав, Львівська обл., 82300","1360","487","1343","24","850","23","873","","0","850","23","873","13","860","223","2","1","0","21","4","8","13","389","61","36","3","8","8","5","0","24","0","30","24","29.10.12"
"461702","121","Львівська область","дитяча школа мистецтв, актова зала, 2-й поверх
вул.Шевченка, 83, м.Борислав, Львівська обл., 82300","804","304","786","12","491","9","500","","0","491","9","500","10","490","132","3","1","1","13","3","6","2","195","61","26","5","2","1","3","0","6","0","10","20","29.10.12"
"461703","121","Львівська область","школа №3, вестибюль, 1-й поверх
вул.Шкільна, 19, м.Борислав, Львівська обл., 82300","1320","513","1297","36","774","33","807","","0","774","33","807","14","793","180","5","4","2","26","4","22","7","342","54","39","3","18","5","8","1","20","2","14","37","29.10.12"
"461704","121","Львівська область","електроцех НГВУ, актова зала, 1-й поверх
вул.С.Бандери, 39, м.Борислав, Львівська обл., 82300","596","236","602","18","342","18","360","","0","342","18","360","6","354","88","1","1","0","6","0","4","6","173","15","15","5","7","1","6","1","2","1","12","10","29.10.12"
"461705","121","Львівська область","прикарпатське УБР, клуб, 2-й поверх
вул.Шевченка, 215, м.Борислав, Львівська обл., 82300","544","181","544","20","345","18","363","","0","345","18","363","7","356","101","0","3","1","8","0","8","4","163","16","13","0","4","1","0","0","6","1","7","20","29.10.12"
"461706","121","Львівська область","школа №6, вестибюль, 2-й поверх
вул.С.Бандери, 102, м.Борислав, Львівська обл., 82300","764","249","771","30","487","28","515","","0","487","28","515","14","501","158","3","2","2","13","2","6","4","219","25","23","1","7","0","3","0","3","0","16","14","29.10.12"
"461707","121","Львівська область","селищний клуб, танцювальна зала, 1-й поверх
вул.Шевченка, 55 корп.А, смт Східниця, м.Борислав, Львівська обл., 82391","632","141","643","19","472","19","491","","0","472","19","491","6","485","139","5","6","1","19","0","5","7","214","20","37","4","7","1","3","0","2","0","1","14","29.10.12"
"461708","121","Львівська область","народний дім ""Просвіта"", концертний зал, 1-й поверх
вул.Промислова, 1, смт Східниця, м.Борислав, Львівська обл., 82391","1476","452","1478","36","990","34","1024","","0","990","34","1024","15","1009","225","3","3","4","22","3","14","18","517","49","69","13","19","2","1","0","5","3","16","23","29.10.12"
"461709","121","Львівська область","Дрогобицький професійний політехнічний ліцей, актова зала
вул.Пушкіна, 20, м.Дрогобич, Львівська обл., 82100","1692","712","1679","11","973","7","980","","0","973","7","980","21","959","78","56","7","2","54","4","48","13","531","43","26","16","40","6","7","5","5","3","1","14","29.10.12"
"461710","121","Львівська область","Дрогобицький механіко-технологічний коледж, актова зала
вул.Раневицька, 12, м.Дрогобич, Львівська обл., 82100","1720","655","1684","36","1034","31","1065","","0","1034","31","1065","66","999","70","70","13","3","33","7","59","19","522","35","45","11","52","19","10","4","9","2","2","14","29.10.12"
"461711","121","Львівська область","школа №16, їдальня
вул.Михайла Грушевського, 136, м.Дрогобич, Львівська обл., 82100","2428","910","2409","28","1491","27","1518","","0","1490","27","1517","33","1484","133","97","30","6","64","8","100","47","676","41","81","38","56","23","10","1","23","4","5","41","29.10.12"
"461712","121","Львівська область","школа №16, спортивний зал
вул.Михайла Грушевського, 136, м.Дрогобич, Львівська обл., 82100","2232","868","2217","24","1348","16","1364","","0","1348","16","1364","32","1332","46","86","13","5","52","15","73","40","697","49","63","33","71","14","11","2","11","8","3","40","30.10.12"
"461713","121","Львівська область","КП ""Дрогобичтеплоенерго"", актова зала
вул.Індустріальна, 1, корп.А, м.Дрогобич, Львівська обл., 82100","1460","632","1442","10","823","5","828","","0","823","5","828","14","814","59","33","22","1","44","5","36","19","422","38","35","16","50","10","1","1","6","0","3","13","29.10.12"
"461714","121","Львівська область","школа №10, актова зала
вул.Є.Коновальця, 11, м.Дрогобич, Львівська обл., 82100","2044","806","2033","20","1222","16","1238","","0","1222","16","1238","23","1215","71","75","22","2","58","9","91","17","638","63","42","24","46","23","13","0","4","1","1","15","29.10.12"
"461715","121","Львівська область","гуртожиток Дрогобицького державного педагогічного університету, спортивний зал
вул.Володимира Великого, 3, м.Дрогобич, Львівська обл., 82100","2264","951","2361","17","1298","15","1313","","0","1298","15","1313","17","1296","78","77","16","2","71","6","67","26","666","58","60","20","82","32","5","4","5","2","3","16","28.10.12"
"461716","121","Львівська область","школа №14, фойє
вул.Михайла Грушевського, 87, м.Дрогобич, Львівська обл., 82100","2284","847","2265","45","1403","34","1437","","0","1403","34","1437","35","1402","120","68","25","2","60","7","78","58","686","50","48","23","69","29","9","2","16","5","1","46","29.10.12"
"461717","121","Львівська область","школа №14, спортивний зал
вул.Михайла Грушевського, 87, м.Дрогобич, Львівська обл., 82100","2076","786","2062","41","1255","35","1290","","0","1255","35","1290","58","1232","77","85","9","6","62","8","84","52","614","28","42","18","53","22","11","3","11","4","4","39","29.10.12"
"461718","121","Львівська область","Дрогобицьке управління газового господарства, актова зала
вул.Стрийська, 104, м.Дрогобич, Львівська обл., 82100","2504","937","2469","37","1537","30","1567","","0","1537","30","1567","36","1531","70","81","43","5","82","11","108","37","760","67","47","30","85","30","17","6","23","1","1","27","29.10.12"
"461719","121","Львівська область","Дрогобицький нафтовий технікум, актова зала
вул.Михайла Грушевського, 57, м.Дрогобич, Львівська обл., 82100","2504","892","2459","30","1586","26","1612","","0","1585","26","1611","33","1578","147","91","20","1","68","10","78","32","771","57","66","17","107","33","7","16","27","2","4","24","29.10.12"
"461720","121","Львівська область","інститут фізики та математики Дрогобицького державного педагогічного університету, ауд.10
вул.Стрийська, 3, м.Дрогобич, Львівська обл., 82100","2440","968","2416","57","1426","46","1472","","0","1426","46","1472","44","1428","76","85","16","6","62","10","79","30","703","73","61","24","69","33","8","8","38","5","1","41","29.10.12"
"461721","121","Львівська область","районний Народний дім, фойє
вул.22 Січня, 28, м.Дрогобич, Львівська обл., 82100","2452","773","2450","47","1639","40","1679","","0","1639","40","1679","34","1645","136","95","23","3","94","7","99","37","850","48","68","23","61","30","8","2","18","3","2","38","29.10.12"
"461722","121","Львівська область","школа №1, їдальня
вул.Петра Сагайдачного, 19, м.Дрогобич, Львівська обл., 82100","2448","788","2431","36","1629","31","1660","","0","1629","31","1660","34","1626","148","88","38","5","95","15","92","44","781","51","55","30","66","38","18","4","19","1","1","37","29.10.12"
"461723","121","Львівська область","медичне училище ""Медик"", к.1
вул.Петра Сагайдачного, 100, м.Дрогобич, Львівська обл., 82100","2476","868","2459","22","1594","14","1608","","0","1594","14","1608","22","1586","115","96","25","0","58","15","119","23","784","63","39","26","124","37","17","1","12","1","3","28","29.10.12"
"461724","121","Львівська область","школа №17, вестибюль 1
вул.Самбірська, 70, м.Дрогобич, Львівська обл., 82100","2392","904","2369","35","1465","23","1488","","0","1465","23","1488","23","1465","113","98","43","4","91","12","107","40","676","62","54","25","76","17","5","2","12","1","2","25","29.10.12"
"461725","121","Львівська область","школа №17, вестибюль 2
вул.Самбірська, 70, м.Дрогобич, Львівська обл., 82100","2412","886","2392","14","1514","12","1526","","0","1514","12","1526","37","1489","100","95","33","3","62","96","9","18","743","43","65","27","85","54","16","3","6","5","2","24","29.10.12"
"461726","121","Львівська область","педагогічний факультет Дрогобицького державного педагогічного університету, ауд.1
вул.Леся Курбаса, 2, м.Дрогобич, Львівська обл., 82100","2236","810","2230","46","1384","42","1426","","0","1384","42","1426","15","1411","127","106","50","0","116","14","93","20","627","58","52","35","55","15","14","3","7","0","0","19","29.10.12"
"461727","121","Львівська область","школа №5, фойє
вул.Зварицька, 57, м.Дрогобич, Львівська обл., 82100","2520","909","2504","51","1567","44","1611","","0","1567","44","1611","47","1564","122","109","39","0","87","12","85","29","791","44","70","47","44","30","11","1","6","4","0","33","29.10.12"
"461728","121","Львівська область","головний корпус Дрогобицького державного педагогічного університету, ауд.1
вул.Івана Франка, 24, м.Дрогобич, Львівська обл., 82100","2212","867","2188","47","1300","45","1345","","0","1300","45","1345","27","1318","73","61","18","4","66","15","65","46","596","55","70","21","85","30","25","3","18","7","3","57","29.10.12"
"461729","121","Львівська область","школа №9, актова зала
вул.Фабрична, 63, м.Дрогобич, Львівська обл., 82100","2500","1044","2491","42","1426","30","1456","","0","1426","30","1456","23","1433","101","86","20","2","106","12","74","26","723","47","81","25","45","17","12","2","8","3","6","37","29.10.12"
"461730","121","Львівська область","Дрогобицьке музичне училище, актова зала
вул.Музична, 3, м.Дрогобич, Львівська обл., 82100","2484","936","2452","41","1515","33","1548","","0","1515","33","1548","40","1508","81","93","24","10","66","12","81","33","686","86","80","38","68","31","16","6","32","5","8","52","29.10.12"
"461731","121","Львівська область","школа №2, актова зала
вул.Лікаря Козловського, 17, м.Дрогобич, Львівська обл., 82100","2488","944","2463","39","1507","37","1544","","0","1507","37","1544","111","1433","90","97","25","4","77","16","105","30","708","28","58","28","63","13","14","7","15","3","5","47","29.10.12"
"461732","121","Львівська область","школа №2, спортивний зал
вул.Лікаря Козловського, 17, м.Дрогобич, Львівська обл., 82100","2504","967","2488","39","1506","31","1537","","0","1506","31","1537","36","1501","80","72","31","2","59","13","113","16","784","34","71","20","90","22","39","4","7","2","7","35","29.10.12"
"461733","121","Львівська область","філія Народного дому, глядацька зала
вул.Дрогобицька, 238, м.Стебник, м.Дрогобич, Львівська обл., 82172","1400","444","1408","36","922","34","956","","0","922","34","956","14","942","10","9","12","1","30","1","27","10","544","18","176","17","28","37","4","1","1","0","1","15","29.10.12"
"461734","121","Львівська область","філія Народного дому, глядацька зала
вул.Зелена Діброва, 71, м.Стебник, м.Дрогобич, Львівська обл., 82172","1136","303","1128","36","798","35","833","","0","798","35","833","12","821","3","9","2","2","18","3","18","5","544","21","129","20","29","6","2","0","1","1","3","5","29.10.12"
"461735","121","Львівська область","Стебницький професійний ліцей, актова зала
вул.Володимира Великого, 2, м.Стебник, м.Дрогобич, Львівська обл., 82172","1472","560","1470","12","904","8","912","","0","904","8","912","16","896","4","13","8","1","12","2","22","15","477","20","226","25","35","5","0","0","4","3","0","24","29.10.12"
"461736","121","Львівська область","Стебницький Народний дім, танцювальна зала
пл.Тараса Шевченка, 5, м.Стебник, м.Дрогобич, Львівська обл., 82172","1556","646","1546","21","895","15","910","","0","895","15","910","24","886","15","12","2","0","21","4","31","14","439","31","220","26","35","6","3","0","9","1","2","15","29.10.12"
"461737","121","Львівська область","школа №7, спортивний зал
вул.Михайла Грушевського, 11, м.Стебник, м.Дрогобич, Львівська обл., 82172","1420","549","1401","18","856","15","871","","0","856","15","871","22","849","13","17","5","0","19","1","24","7","488","39","161","26","28","3","0","0","8","1","2","7","29.10.12"
"461738","121","Львівська область","школа №6, їдальня
вул.Михайла Грушевського, 10, м.Стебник, м.Дрогобич, Львівська обл., 82172","1980","732","1950","27","1224","24","1248","","0","1224","24","1248","20","1228","15","18","15","3","41","40","25","10","665","37","252","32","25","15","4","1","6","2","1","21","29.10.12"
"461739","121","Львівська область","Стебницька музична школа, к.1
вул.Січових Стрільців, 1, м.Стебник, м.Дрогобич, Львівська обл., 82172","1516","639","1512","17","861","16","877","","0","861","16","877","13","864","15","17","12","4","11","4","17","13","444","35","192","21","36","8","2","2","5","0","3","23","29.10.12"
"461740","121","Львівська область","школа №11, спортивний зал
вул.Пантелеймона Куліша, 3, м.Стебник, м.Дрогобич, Львівська обл., 82172","1976","752","1972","37","1190","34","1224","","0","1190","34","1224","25","1199","18","15","5","5","24","5","30","17","634","33","327","20","26","10","0","0","11","1","1","17","29.10.12"
"461741","121","Львівська область","школа №18, фойє
вул.Петра Дорошенка, 1, м.Стебник, м.Дрогобич, Львівська обл., 82172","2184","822","2183","50","1321","41","1362","","0","1321","41","1362","36","1326","9","11","15","2","22","2","13","9","684","20","422","19","49","10","6","0","5","3","0","25","29.10.12"
"461742","121","Львівська область","Дрогобицька міська лікарня №1, актова зала
вул.Андрея Шептицького, 9, м.Дрогобич, Львівська обл., 82100","104","10","161","52","57","37","94","","0","57","37","94","1","93","6","6","2","0","9","3","5","1","46","4","3","1","3","0","1","0","2","1","0","0","29.10.12"
"461743","121","Львівська область","Дрогобицька виправна колонія №40, зала засідань
вул.Трускавецька, 77, м.Дрогобич, Львівська обл., 82100","1232","71","1207","0","1161","0","1161","","0","1161","0","1161","216","945","35","60","31","28","39","26","38","69","183","37","25","16","21","8","18","13","48","20","20","210","30.10.12"
"461808","121","Львівська область","санаторій ""Дніпро"", кіно-концертна зала, 1-й поверх
вул.Мазепи, 1, м.Трускавець, Львівська обл., 82200","2344","869","2323","28","1452","23","1475","","0","1452","23","1475","19","1456","74","47","25","25","64","9","67","35","809","40","86","17","44","22","16","2","15","3","7","49","29.10.12"
"461809","121","Львівська область","школа №1, спортивний зал, 1-й поверх
вул.Садова, 14, м.Трускавець, Львівська обл., 82200","2276","854","2254","40","1383","39","1422","","0","1383","39","1422","30","1392","68","33","24","43","92","4","47","15","806","51","75","12","30","11","11","2","13","1","6","48","29.10.12"
"461810","121","Львівська область","міська бібліотека, читальна зала, 2-й поверх
вул.Дрогобицька, 12, м.Трускавець, Львівська обл., 82200","1636","553","1632","18","1072","11","1083","","0","1072","11","1083","17","1066","55","30","9","36","60","4","55","22","558","30","87","12","23","13","13","0","9","3","12","35","30.10.12"
"461811","121","Львівська область","палац культури ім. Шевченка, фойє глядацького залу, 2-й поверх
майдан Кобзаря, 8, м.Трускавець, Львівська обл., 82200","1304","445","1308","33","828","31","859","","0","828","31","859","21","838","46","27","9","30","50","5","47","20","444","29","51","9","25","10","7","0","8","4","2","15","29.10.12"
"461812","121","Львівська область","школа №3, спортивний зал, 2-й поверх
вул.Стебницька, 98, м.Трускавець, Львівська обл., 82200","2348","889","2316","15","1448","11","1459","","0","1448","11","1459","34","1425","89","56","8","42","77","14","74","27","741","45","79","15","52","20","15","4","7","3","5","52","29.10.12"
"461813","121","Львівська область","будинок учнівської творчості, актова зала, 1-й поверх
вул.Стебницька, 12, м.Трускавець, Львівська обл., 82200","2188","843","2164","39","1314","31","1345","","0","1314","31","1345","30","1315","54","32","25","44","86","4","40","33","702","30","93","17","38","25","5","3","17","4","5","58","29.10.12"
"461814","121","Львівська область","школа №2, вестибюль, 1-й поверх
вул.Данилишиних, 19, м.Трускавець, Львівська обл., 82200","2380","860","2369","23","1500","20","1520","","0","1500","20","1520","22","1498","58","64","14","34","83","8","73","31","822","32","93","10","53","16","10","2","12","4","24","55","29.10.12"
"461815","121","Львівська область","спортивний комплекс ""Спортовець"", спортивний зал, 2-й поверх
вул.Данилишиних, 11, м.Трускавець, Львівська обл., 82200","2364","881","2345","64","1434","49","1483","","0","1434","49","1483","27","1456","60","49","14","28","77","6","69","31","776","33","81","5","81","11","21","9","29","4","6","66","29.10.12"
