"№ ВД","OBO","Назва регіону України","Місцезнаходження та адреса приміщення для голосування","1) К-сть одержаних бюлетенів","2) К-сть невикористаних бюлетенів","3) К-сть виборців, внесених до списку виборців","4) К-сть виборців, внесених до витягу зі списку виборців","5) К-сть виборців, які отримали бюлетені у приміщенні","6) К-сть виборців, які отримали за місцем перебування","7) Сумарна к-сть виборців, які отримали бюлетені","8) К-сть бюлетенів, що виявилися у кожній скринці","9) К-сть бюлетенів, що не підлягають врахуванню","10) К-сть виборців, які взяли участь у голос. у приміщенні для гол.","11) К-сть виборців, які взяли участь у голос. за місцем перебування","12) К-сть виборців, які взяли участь у голосуванні на виборчій дільниці","13) К-сть бюлетенів, визнаних недійсними","14) Сумарна к-сть голосів виборців ЗА","Гурський
Володимир
Сергійович","Загородний
Василь
Іванович","Канівець
Олег
Леонідович","Канівець
Сергій
Миколайович","Кіт
Андрій
Богданович","Михайлишин
Петро
Степанович","Муряш
Андрій
Богданович","Осташ
Ігор
Іванович","Рябошапко
Василь
Іванович","Семенюк
Анна
Богданівна","Сидоренко
Олександр
Нестерович","Тенюх
Ігор
Йосифович","Дата підписання протоколу"
"000001","126","Львівська область","
Відділення ""Лікувально-діагностичний центр"" вул.С.Бандери, 4, м.Моршин, Львівська обл., 82482","936","467","1055","0","469","0","469","","0","469","0","469","14","455","14","63","175","21","101","6","1","6","2","18","25","23","29.10.12"
"000002","126","Львівська область","
вул. Джерельна, 5, Львівська обл.,82482","306","223","157","0","83","0","83","","0","83","0","83","7","76","3","15","23","3","15","1","0","1","1","3","8","3","29.10.12"
"460298","126","Львівська область","Народний дім, актовий зал
вул.Шкільна, 119, с.Вибранівка, Жидачівський р-н, Львівська обл., 81710","510","183","508","42","288","39","327","","0","288","39","327","5","322","1","4","134","14","140","1","0","9","3","3","1","12","29.10.12"
"460299","126","Львівська область","Народний дім, актовий зал
вул.Зелена, 26, с.Бринці-Загірні, Жидачівський р-н, Львівська обл., 81710","186","58","181","18","112","16","128","","0","112","16","128","0","128","0","1","94","9","20","1","0","1","2","0","0","0","29.10.12"
"460300","126","Львівська область","Адмінбудинок сільської ради, зал засідань
вул.Зарічна, 22, с.Бринці-Церковні, Жидачівський р-н, Львівська обл., 81710","300","72","294","24","204","24","228","","0","204","24","228","9","219","0","4","123","14","68","2","1","0","0","2","0","5","29.10.12"
"460301","126","Львівська область","фельдшерсько-акушерський пункт, кімната для прийому хворих
вул.Шевченка, 9, с.Борусів, Жидачівський р-н, Львівська обл., 81710","132","30","131","10","92","10","102","","0","92","10","102","0","102","0","0","63","4","34","0","0","0","0","1","0","0","29.10.12"
"460302","126","Львівська область","Народний дім, актовий зал
вул.І.Франка, 21, с.Чижичі, Жидачівський р-н, Львівська обл., 81710","132","39","128","10","83","10","93","","0","83","10","93","6","87","0","0","44","4","37","0","0","1","0","1","0","0","29.10.12"
"460303","126","Львівська область","Народний дім ""Просвіта"", актовий зал
вул.Л.Українки, 9, с.Ходорківці, Жидачівський р-н, Львівська обл., 81713","162","35","161","7","123","4","127","","0","123","4","127","2","125","0","6","33","4","79","0","0","2","0","1","0","0","29.10.12"
"460304","126","Львівська область","школа, кабінет фізики
вул.Миру, 36, с.Соколівка, Жидачівський р-н, Львівська обл., 81713","60","11","59","5","44","5","49","","0","44","5","49","1","48","0","0","11","1","34","0","0","1","0","0","0","1","29.10.12"
"460305","126","Львівська область","Народний дім ""Просвіта"", актовий зал
вул.Січових Стрільців, 8, с.Кологори, Жидачівський р-н, Львівська обл., 81713","222","31","219","24","167","24","191","","0","167","24","191","1","190","1","3","40","7","129","2","1","1","0","3","0","3","29.10.12"
"460306","126","Львівська область","Народний дім ""Просвіта"", актовий зал
вул.Першотравнева, 3, с.П’ятничани, Жидачівський р-н, Львівська обл., 81713","144","28","144","12","104","12","116","","0","104","12","116","1","115","0","4","41","6","63","0","0","1","0","0","0","0","29.10.12"
"460307","126","Львівська область","житловий будинок, к.1
вул.Воз’єднання, 7, с.Сенів, Жидачівський р-н, Львівська обл., 81713","42","7","38","4","31","4","35","","0","31","4","35","1","34","0","0","5","2","27","0","0","0","0","0","0","0","29.10.12"
"460308","126","Львівська область","Народний дім, актовий зал
вул.1 Травня, 33, с.Квітневе, Жидачівський р-н, Львівська обл., 81714","294","29","295","26","239","26","265","","0","239","26","265","4","261","0","5","99","9","137","1","1","6","1","0","2","0","29.10.12"
"460309","126","Львівська область","Народний дім, актовий зал
вул.Джерельна, 35А, с.Трибоківці, Жидачівський р-н, Львівська обл., 81712","210","40","209","8","164","6","170","","0","164","6","170","4","166","0","0","60","6","98","0","0","2","0","0","0","0","28.10.12"
"460310","126","Львівська область","Народний дім, актовий зал
вул.Львівська, 47, с.Репехів, Жидачівський р-н, Львівська обл., 81712","174","29","174","19","130","15","145","","0","130","15","145","1","144","0","0","51","4","83","0","0","5","0","1","0","0","29.10.12"
"460311","126","Львівська область","Народний дім, актовий зал
вул.Миру, 8, с.Баківці, Жидачівський р-н, Львівська обл., 81712","234","36","234","14","184","14","198","","0","184","14","198","3","195","0","1","79","7","105","3","0","0","0","0","0","0","29.10.12"
"460312","126","Львівська область","Народний дім, актовий зал
вул.І.Франка, 14, с.Дев’ятники, Жидачівський р-н, Львівська обл., 81711","288","84","288","25","179","25","204","","0","179","25","204","5","199","0","7","66","9","104","1","0","5","0","2","0","5","29.10.12"
"460313","126","Львівська область","Народний дім, актовий зал
вул.Шевченка, 21, с.Юшківці, Жидачівський р-н, Львівська обл., 81711","132","32","128","18","83","17","100","","0","83","17","100","0","100","0","0","54","7","35","0","2","1","1","0","0","0","29.10.12"
"460314","126","Львівська область","Народний дім, актовий зал
вул.Жовтнева, 3, с.Прибілля, Жидачівський р-н, Львівська обл., 81711","90","29","84","12","50","11","61","","0","50","11","61","2","59","0","0","14","0","43","1","0","0","0","0","0","1","29.10.12"
"460315","126","Львівська область","Народний дім, актовий зал
вул.Л.Українки, 39, с.Калинівка, Жидачівський р-н, Львівська обл., 81711","102","38","99","9","57","7","64","","0","57","7","64","1","63","0","8","27","2","25","0","0","1","0","0","0","0","29.10.12"
"460316","126","Львівська область","Народний дім, актовий зал
вул.Гагаріна, 1, с.Бертишів, Жидачівський р-н, Львівська обл., 81714","132","29","128","17","86","17","103","","0","86","17","103","0","103","0","5","26","6","65","0","0","1","0","0","0","0","28.10.12"
"460317","126","Львівська область","Народний дім, актовий зал
вул.Мороза, 1, с.Орішківці, Жидачівський р-н, Львівська обл., 81716","138","33","139","17","90","15","105","","0","90","15","105","4","101","0","3","60","6","31","0","0","0","0","0","1","0","29.10.12"
"460318","126","Львівська область","школа, кл.9
вул.Микулінського, 5, с.Кнісело, Жидачівський р-н, Львівська обл., 81716","252","74","245","22","160","18","178","","0","160","18","178","6","172","0","6","110","7","42","0","0","1","0","0","0","6","29.10.12"
"460319","126","Львівська область","школа, актовий зал
вул.Шевченка, 7, смт Нові Стрілища, Жидачівський р-н, Львівська обл., 81714","714","221","707","52","443","50","493","","0","443","50","493","3","490","2","8","263","25","162","1","0","15","1","1","0","12","29.10.12"
"460320","126","Львівська область","Народний дім, актовий зал
вул.Космонавтів, 12, с.Старі Стрілища, Жидачівський р-н, Львівська обл., 81714","198","67","197","27","107","24","131","","0","107","24","131","1","130","0","2","28","1","96","0","1","1","0","1","0","0","29.10.12"
"460321","126","Львівська область","школа, кл.7
вул.Коновальця, 4, с.Бориничі, Жидачівський р-н, Львівська обл., 81721","534","146","540","53","337","51","388","","0","337","51","388","7","381","2","1","190","16","159","3","1","3","0","1","0","5","29.10.12"
"460322","126","Львівська область","Народний дім, актовий зал
вул.Л.Українки, 32, с.Дроховичі, Жидачівський р-н, Львівська обл., 81721","72","14","71","13","47","11","58","","0","47","11","58","2","56","0","0","29","4","23","0","0","0","0","0","0","0","29.10.12"
"460323","126","Львівська область","школа, актовий зал
вул.Галицька, 84, с.Чорний Острів, Жидачівський р-н, Львівська обл., 81721","600","157","595","71","373","70","443","","0","373","70","443","6","437","2","5","262","19","140","0","0","2","0","1","1","5","29.10.12"
"460324","126","Львівська область","магазин, торговий зал
вул.Галицька, 25, с.Голдовичі, Жидачівський р-н, Львівська обл., 81720","78","16","75","5","57","5","62","","0","57","5","62","2","60","1","0","25","3","30","0","0","1","0","0","0","0","29.10.12"
"460325","126","Львівська область","Народний дім, актовий зал
вул.І.Франка, 18, с.Лучани, Жидачівський р-н, Львівська обл., 81720","174","32","176","18","126","16","142","","0","126","16","142","7","135","0","2","42","5","73","1","0","5","0","0","1","6","30.10.12"
"460326","126","Львівська область","школа, спортзал
вул.Зелена, 4, с.Ліщини, Жидачівський р-н, Львівська обл., 81717","402","105","405","28","270","27","297","","0","270","27","297","10","287","1","1","136","31","110","1","0","5","0","2","0","0","29.10.12"
"460327","126","Львівська область","школа, актовий зал
вул.Центральна, 51, с.Грусятичі, Жидачівський р-н, Львівська обл., 81717","642","161","648","59","424","57","481","","0","424","57","481","8","473","1","1","184","17","244","1","0","5","1","7","1","11","29.10.12"
"460328","126","Львівська область","школа, актовий зал
вул.Просвіти, 53, с.Рудківці, Жидачівський р-н, Львівська обл., 81722","336","81","335","29","227","28","255","","0","227","28","255","2","253","0","5","46","5","183","2","0","6","0","1","4","1","29.10.12"
"460329","126","Львівська область","навчально-виховний комплекс, актовий зал
вул.Ходорівська, 50А, с.Піддністряни, Жидачівський р-н, Львівська обл., 81722","570","137","575","35","399","34","433","","0","399","34","433","6","427","2","1","190","19","159","1","1","36","0","2","0","16","29.10.12"
"460330","126","Львівська область","навчально-виховний комплекс, кабінет математики
вул.Ходорівська, 54А, с.Кам’яне, Жидачівський р-н, Львівська обл., 81723","438","77","448","23","338","23","361","","0","338","23","361","4","357","1","0","217","20","95","1","0","0","0","10","2","11","29.10.12"
"460331","126","Львівська область","школа, кл.1-4
вул.Шкільна, 42, с.Городищенське, Жидачівський р-н, Львівська обл., 81724","354","105","352","19","234","15","249","","0","234","15","249","2","247","0","2","64","8","158","0","1","3","1","1","0","9","30.10.12"
"460332","126","Львівська область","школа, спортзал
пл.Свободи, 8, с.Отиневичі, Жидачівський р-н, Львівська обл., 81724","558","195","552","38","325","38","363","","0","325","38","363","5","358","1","0","164","11","154","3","0","8","0","0","1","16","29.10.12"
"460333","126","Львівська область","школа, актовий зал
вул.Центральна, 4, с.Дуліби, Жидачівський р-н, Львівська обл., 81725","816","261","816","50","508","47","555","","0","508","47","555","18","537","0","0","156","19","353","1","0","3","0","2","0","3","29.10.12"
"460334","126","Львівська область","Народний дім ""Просвіта"", актовий зал
вул.Шевченка, 8, с.Дем’янка-Лісна, Жидачівський р-н, Львівська обл., 81730","366","105","365","6","255","6","261","","0","255","6","261","10","251","1","6","99","11","92","8","2","10","0","0","0","22","29.10.12"
"460335","126","Львівська область","Народний дім ""Просвіта"", актовий зал
вул.Львівська, 44, с.Дем’янка-Наддністрянська, Жидачівський р-н, Львівська обл., 81730","162","33","158","2","127","2","129","","0","127","2","129","2","127","0","5","61","8","37","1","1","7","1","3","0","3","29.10.12"
"460336","126","Львівська область","Народний дім ""Просвіта"", актовий зал
вул.Січових Стрільців, 11, с.Заріччя, Жидачівський р-н, Львівська обл., 81730","528","151","520","8","369","8","377","","0","369","8","377","6","371","1","4","191","16","105","9","2","14","1","1","0","27","29.10.12"
"460337","126","Львівська область","Народний дім ""Просвіта"", актовий зал
вул.Шевченка, 8, с.Межиріччя, Жидачівський р-н, Львівська обл., 81730","492","144","495","20","328","20","348","","0","328","20","348","6","342","4","8","195","15","79","5","1","12","1","9","0","13","29.10.12"
"460338","126","Львівська область","школа, к.1
вул.Перемоги, 18, с.Городище, Жидачівський р-н, Львівська обл., 81726","336","82","340","19","237","17","254","","0","237","17","254","4","250","1","4","125","14","100","0","0","1","0","0","0","5","29.10.12"
"460339","126","Львівська область","Адмінбудинок сільської ради, кімната урочистих подій
вул.Січових Стрільців, 14, с.Жирова, Жидачівський р-н, Львівська обл., 81726","948","314","947","30","605","29","634","","0","0","0","634","14","620","0","2","206","15","322","3","0","22","1","5","1","43","30.10.12"
"460340","126","Львівська область","школа, кабінет трудового навчання
вул.Л.Українки, 23, с.Заліски, Жидачівський р-н, Львівська обл., 81726","432","113","442","24","295","24","319","","0","295","24","319","5","314","1","2","122","9","163","2","0","6","0","2","1","6","29.10.12"
"460341","126","Львівська область","Народний дім, актовий зал
вул.Центральна, 23, с.Бородчиці, Жидачівський р-н, Львівська обл., 81726","156","35","153","8","113","8","121","","0","113","8","121","6","115","2","0","59","6","45","0","0","0","0","1","1","1","29.10.12"
"460342","126","Львівська область","Народний дім, актовий зал
вул.Грушевського, 46, м.Ходорів, Жидачівський р-н, Львівська обл., 81750","1548","623","1553","37","893","32","925","","0","893","32","925","12","913","2","8","262","27","558","5","1","12","1","4","1","32","29.10.12"
"460343","126","Львівська область","школа №1, актовий зал
вул.Шевченка, 30, м.Ходорів, Жидачівський р-н, Львівська обл., 81750","1734","691","1711","31","1014","29","1043","","0","1014","29","1043","19","1024","1","7","196","22","710","7","1","13","0","5","8","54","30.10.12"
"460344","126","Львівська область","Технічний коледж, кабінет спецдисциплін
вул.Грушевського, 3, м.Ходорів, Жидачівський р-н, Львівська обл., 81750","1542","581","1528","36","927","34","961","","0","927","34","961","11","950","2","6","205","31","645","7","0","5","0","4","2","43","28.10.12"
"460345","126","Львівська область","Народний дім, актовий зал
вул.Грушевського, 29, м.Ходорів, Жидачівський р-н, Львівська обл., 81750","1680","601","1653","38","1043","36","1079","","0","1043","36","1079","22","1057","0","7","260","31","673","12","0","16","1","2","2","53","29.10.12"
"460346","126","Львівська область","школа №3, актовий зал
вул.Грушевського, 4, м.Ходорів, Жидачівський р-н, Львівська обл., 81750","1596","660","1597","12","925","11","936","","0","925","11","936","8","928","1","4","240","30","613","3","2","7","0","2","6","20","29.10.12"
"460347","126","Львівська область","школа, кл.1-3
вул.Грушевського, 2, с.Садки, Жидачівський р-н, Львівська обл., 81751","216","90","212","4","122","4","126","","0","122","4","126","1","125","1","2","52","8","54","1","1","3","1","0","0","2","29.10.12"
"460348","126","Львівська область","школа, спортзал
вул.Б.Хмельницького, 17, с.Вовчатичі, Жидачівський р-н, Львівська обл., 81761","810","251","809","16","543","16","559","","0","543","16","559","17","542","1","14","97","13","356","2","0","4","2","1","3","49","29.10.12"
"460349","126","Львівська область","школа, кл.5-9
вул.І.Франка, 9, с.Сугрів, Жидачівський р-н, Львівська обл., 81762","342","121","336","9","212","9","221","","0","212","9","221","10","211","0","13","59","12","123","0","0","1","0","0","0","3","29.10.12"
"460350","126","Львівська область","школа, спортзал
вул.Шкільна, 2, с.Вербиця, Жидачівський р-н, Львівська обл., 81760","294","70","291","8","216","8","224","","0","216","8","224","2","222","0","5","99","12","103","0","0","0","1","1","0","1","29.10.12"
"460351","126","Львівська область","Народний дім, актовий зал
вул.Партицького, 19, с.Тейсарів, Жидачівський р-н, Львівська обл., 81736","606","98","600","27","482","26","508","","0","482","26","508","7","501","0","12","334","22","55","2","19","1","0","2","1","53","29.10.12"
"460352","126","Львівська область","Народний дім, актовий зал
вул.Шевченка, 63А, с.Пчани, Жидачівський р-н, Львівська обл., 81734","540","114","543","32","394","32","426","","0","394","32","426","9","417","1","10","228","33","62","5","0","14","0","4","0","60","29.10.12"
"460353","126","Львівська область","Народний дім, актовий зал
вул.Шашкевича, 13, с.Вільхівці, Жидачівський р-н, Львівська обл., 81733","336","56","341","21","259","21","280","","0","259","21","280","7","273","0","3","192","13","39","4","0","2","0","2","0","18","29.10.12"
"460354","126","Львівська область","школа, спортзал
вул.Шевченка, 93А, с.Волиця-Гніздичівська, Жидачівський р-н, Львівська обл., 81733","306","76","305","7","224","6","230","","0","224","6","230","8","222","0","9","97","20","58","4","0","3","0","1","0","30","29.10.12"
"460355","126","Львівська область","школа, кл.1-3
вул.Шкільна, 1, с.Туради, Жидачівський р-н, Львівська обл., 81733","420","103","420","17","302","15","317","","0","302","15","317","12","305","1","4","193","17","46","4","1","1","0","2","0","36","29.10.12"
"460356","126","Львівська область","Народний дім, актовий зал
вул.Шевченка, 7А, с.Іванівці, Жидачівський р-н, Львівська обл., 81733","330","84","331","7","239","7","246","","0","239","7","246","3","243","1","9","114","18","49","5","0","22","0","1","0","24","28.10.12"
"460357","126","Львівська область","будинок культури ""Папірник"", фойє
вул.Шевченка, 1, м.Жидачів, Жидачівський р-н, Львівська обл., 81700","1626","585","1615","22","1020","21","1041","","0","1020","21","1041","21","1020","3","19","385","34","298","75","3","33","1","12","16","141","29.10.12"
"460358","126","Львівська область","Жидачівська ДЮСШ, спортзал
вул.Грушевського, 69, м.Жидачів, Жидачівський р-н, Львівська обл., 81700","1524","521","1513","32","974","29","1003","","0","974","29","1003","16","987","1","8","336","25","369","60","0","44","3","8","4","129","29.10.12"
"460359","126","Львівська область","школа №2, фойє
вул.Грушевського, 38, м.Жидачів, Жидачівський р-н, Львівська обл., 81700","1794","628","1793","19","1152","14","1166","","0","1152","14","1166","23","1143","4","18","516","31","334","76","0","39","2","14","12","97","29.10.12"
"460360","126","Львівська область","навчально-виховний комплекс, актовий зал
вул.Шкільна, 8, м.Жидачів, Жидачівський р-н, Львівська обл., 81700","1536","557","1526","36","947","32","979","","0","947","32","979","27","952","5","22","432","49","241","46","0","30","0","7","18","102","29.10.12"
"460361","126","Львівська область","гімназія ім.О.Партицького, актовий зал
вул.І.Франка, 7, м.Жидачів, Жидачівський р-н, Львівська обл., 81700","1734","587","1728","22","1127","20","1147","","0","1127","20","1147","19","1128","3","13","490","36","351","50","2","24","0","16","13","130","29.10.12"
"460362","126","Львівська область","навчально-виховний комплекс, фойє
вул.Центральна, 2, с.Загірочко, Жидачівський р-н, Львівська обл., 81754","636","189","645","33","415","32","447","","0","415","32","447","5","442","1","2","148","18","251","0","1","1","1","2","0","17","29.10.12"
"460363","126","Львівська область","школа, к.2
вул.Грушевського, 7, с.Добрівляни, Жидачівський р-н, Львівська обл., 81752","330","71","331","26","233","26","259","","0","233","26","259","5","254","1","1","106","12","117","0","0","0","0","2","0","15","29.10.12"
"460364","126","Львівська область","адмінбудинок колгоспу, актовий зал
вул.Грушевського, 3, смт Гніздичів, Жидачівський р-н, Львівська обл., 81740","1296","443","1276","67","787","66","853","","0","787","66","853","16","837","1","13","379","26","313","7","1","12","1","15","3","66","29.10.12"
"460365","126","Львівська область","Народний дім, актовий зал
вул.Грушевського, 198, смт Гніздичів, Жидачівський р-н, Львівська обл., 81740","1992","518","1977","93","1387","87","1474","","0","1387","87","1474","30","1444","2","11","470","59","657","18","0","21","4","12","1","189","29.10.12"
"460366","126","Львівська область","школа, актовий зал
вул.І.Франка, 96, с.Покрівці, Жидачівський р-н, Львівська обл., 81742","480","128","480","18","334","18","352","","0","334","18","352","9","343","0","1","168","23","110","2","2","10","1","2","3","21","29.10.12"
"460367","126","Львівська область","школа, актовий зал
вул.Л.Українки, 74А, с.Рогізно, Жидачівський р-н, Львівська обл., 81745","492","83","495","28","381","28","409","","0","381","28","409","15","394","0","10","203","28","130","5","1","5","0","0","0","12","29.10.12"
"460368","126","Львівська область","житловий будинок, к.1
вул.Зелена, 1, с.Загурщина, Жидачівський р-н, Львівська обл., 81745","90","27","84","2","61","2","63","","0","61","2","63","0","63","1","1","34","4","15","0","0","1","0","0","0","7","28.10.12"
"460369","126","Львівська область","школа, актовий зал
вул.Дорошенка, 21А, с.Бережниця, Жидачівський р-н, Львівська обл., 81743","864","283","858","18","564","17","581","","0","564","17","581","15","566","5","1","212","40","230","4","1","6","1","6","3","57","29.10.12"
"460370","126","Львівська область","школа, кл.1
вул.Лісна, 37А, с.Журавків, Жидачівський р-н, Львівська обл., 81743","270","54","272","12","204","12","216","","0","204","12","216","7","209","0","1","88","18","85","2","0","4","0","0","1","10","30.10.12"
"460371","126","Львівська область","школа, спортзал
вул.Миру, 93А, с.Заболотівці, Жидачівський р-н, Львівська обл., 81744","546","132","544","31","383","31","414","","0","383","31","414","9","405","0","2","260","30","69","4","0","6","0","5","0","29","29.10.12"
"460372","126","Львівська область","школа, кл.1-3
вул.Шевченка, 55, с.Демидів, Жидачівський р-н, Львівська обл., 81763","234","79","225","27","132","23","155","","0","132","23","155","4","151","0","5","47","3","88","0","0","1","0","0","2","5","28.10.12"
"460373","126","Львівська область","школа, кл.1-3
вул.Надбережна, 27, с.Молотів, Жидачівський р-н, Львівська обл., 81763","96","35","96","6","55","6","61","","0","55","6","61","0","61","0","5","24","1","28","0","1","0","0","0","0","2","29.10.12"
"460374","126","Львівська область","Народний дім, актовий зал
вул.Л.Українки, 48, с.Буковина, Жидачівський р-н, Львівська обл., 81764","348","104","343","29","215","29","244","","0","215","29","244","5","239","0","9","55","10","153","1","2","2","0","1","0","6","29.10.12"
"460375","126","Львівська область","школа, їдальня
вул.І.Франка, 51, с.Бортники, Жидачівський р-н, Львівська обл., 81763","774","259","769","20","496","19","515","","0","496","19","515","7","508","1","10","181","23","266","2","0","6","0","5","1","13","29.10.12"
"460376","126","Львівська область","Народний дім, актовий зал
вул.Миру, 30, с.Підліски, Жидачівський р-н, Львівська обл., 81765","108","36","109","11","63","9","72","","0","63","9","72","4","68","0","1","9","3","55","0","0","0","0","0","0","0","29.10.12"
"460377","126","Львівська область","школа, кабінет фізики
вул.Шевченка, 11, с.Молодинче, Жидачівський р-н, Львівська обл., 81765","222","54","223","14","158","10","168","","0","158","10","168","5","163","1","4","81","9","62","1","0","0","1","1","1","2","29.10.12"
"460378","126","Львівська область","Народний дім, актовий зал
вул.Грушевського, 31, с.Черемхів, Жидачівський р-н, Львівська обл., 81765","156","30","159","19","107","19","126","","0","107","19","126","1","125","0","6","68","3","22","0","0","2","0","0","0","24","29.10.12"
"460379","126","Львівська область","Народний дім, актовий зал
вул.С.Бандери, 3, с.Новосільці, Жидачівський р-н, Львівська обл., 81765","306","92","300","30","186","28","214","","0","186","28","214","1","213","0","5","89","16","86","1","0","1","0","2","0","13","29.10.12"
"460380","126","Львівська область","Народний дім, актовий зал
вул.Центральна, 27, с.Руда, Жидачівський р-н, Львівська обл., 81770","498","112","501","25","361","25","386","","0","361","25","386","6","380","0","4","192","27","106","3","0","6","1","2","2","37","29.10.12"
"460381","126","Львівська область","школа, к.1
вул.І.Франка, 44, с.Ганнівці, Жидачівський р-н, Львівська обл., 81770","204","37","204","13","155","12","167","","0","155","12","167","2","165","0","0","69","9","78","0","0","4","0","0","1","4","29.10.12"
"460382","126","Львівська область","Народний дім ""Просвіта"", актовий зал
вул.Шевченка, 84, с.Лівчиці, Жидачівський р-н, Львівська обл., 81771","762","175","755","33","555","32","587","","0","555","32","587","14","573","0","9","289","40","183","9","0","9","1","3","0","30","30.10.12"
"460383","126","Львівська область","школа, актовий зал
вул.І.Франка, 36, с.Млиниська, Жидачівський р-н, Львівська обл., 81772","522","142","518","36","345","35","380","","0","345","35","380","9","371","1","2","131","8","208","1","0","5","1","1","2","11","29.10.12"
"460384","126","Львівська область","школа, кл.5-9
вул.Л.Українки, 122, с.Голешів, Жидачівський р-н, Львівська обл., 81772","300","95","301","32","174","31","205","","0","174","31","205","3","202","0","7","99","16","55","1","1","13","0","1","0","9","29.10.12"
"460385","126","Львівська область","адмінбудинок сільської ради, зал урочистий подій
вул.І.Франка, 42, с.Млиниська, Жидачівський р-н, Львівська обл., 81772","270","66","272","16","190","14","204","","0","190","14","204","3","201","0","7","91","6","75","7","0","0","0","0","0","15","29.10.12"
"460386","126","Львівська область","магазин, торговий зал
вул.В.Чорновола, 4, с.Корнелівка, Жидачівський р-н, Львівська обл., 81774","66","11","65","6","49","6","55","","0","49","6","55","3","52","0","2","35","3","7","0","0","0","0","0","0","5","29.10.12"
"460387","126","Львівська область","Народний дім, актовий зал
вул.Шевченка, 58, с.Нове Село, Жидачівський р-н, Львівська обл., 81774","282","74","280","28","180","28","208","","0","180","28","208","2","206","0","10","105","14","37","1","0","2","0","2","1","34","29.10.12"
"460388","126","Львівська область","Народний дім, актовий зал
вул.Стрийська, 25, с.Облазниця, Жидачівський р-н, Львівська обл., 81773","192","50","187","25","120","22","142","","0","120","22","142","2","140","0","0","74","5","34","0","0","3","0","2","1","21","29.10.12"
"460389","126","Львівська область","фельдшерсько-акушерський пункт, к.1
вул.Стрийська, 24, с.Жирівське, Жидачівський р-н, Львівська обл., 81775","288","77","293","24","188","23","211","","0","188","23","211","2","209","0","18","93","7","53","1","0","2","0","1","0","34","29.10.12"
"460390","126","Львівська область","Народний дім, актовий зал
вул.І.Франка, 33, с.Махлинець, Жидачівський р-н, Львівська обл., 81774","66","17","66","4","45","4","49","","0","45","4","49","0","49","0","15","20","6","4","2","0","0","0","0","0","2","29.10.12"
"460391","126","Львівська область","школа, к.1
вул.Жовтнева, 42, с.Любша, Жидачівський р-н, Львівська обл., 81775","396","143","393","29","226","27","253","","0","226","27","253","6","247","0","12","131","7","75","2","0","4","0","3","0","13","29.10.12"
"460392","126","Львівська область","навчально-виховний комплекс, к.1
вул.І.Франка, 75, с.Антонівка, Жидачівський р-н, Львівська обл., 81776","360","99","367","24","237","24","261","","0","237","24","261","6","255","1","1","143","15","82","1","0","2","0","2","0","8","29.10.12"
"460393","126","Львівська область","адмінбудинок сільської ради, кабінет голови
вул.Жовтнева, 1, с.Любша, Жидачівський р-н, Львівська обл., 81775","288","74","293","23","191","23","214","","0","191","23","214","3","211","0","3","127","11","43","0","0","2","0","1","0","24","29.10.12"
"460394","126","Львівська область","Народний дім, актовий зал
пл.Бандери, 23, смт Журавно, Жидачівський р-н, Львівська обл., 81780","1440","551","1419","69","823","66","889","","0","823","66","889","18","871","3","8","405","33","219","2","0","5","0","12","2","182","29.10.12"
"460395","126","Львівська область","Журавнівський НВК ""СЗШ-ліцей"", фойє
вул.Валова, 13, смт Журавно, Жидачівський р-н, Львівська обл., 81780","1320","527","1301","36","760","33","793","","0","760","33","793","14","779","4","13","316","42","183","7","1","13","1","3","2","194","29.10.12"
"460396","126","Львівська область","Новошинський НВК ""ЗОНЗ-ДНЗ"", актовий зал
вул.Шевченка, 45, с.Новошини, Жидачівський р-н, Львівська обл., 81782","342","88","341","23","231","23","254","","0","231","23","254","2","252","1","3","109","23","91","12","1","3","0","3","0","6","29.10.12"
"460397","126","Львівська область","Народний дім, актовий зал
вул.Л.Українки, 1, с.Маринка, Жидачівський р-н, Львівська обл., 81783","78","25","78","6","47","6","53","","0","47","6","53","0","53","0","6","22","0","14","0","0","1","0","0","0","10","29.10.12"
"460398","126","Львівська область","школа, актовий зал
вул.Шкільна, 15, с.Володимирці, Жидачівський р-н, Львівська обл., 81783","612","200","606","32","383","29","412","","0","383","29","412","4","408","1","5","131","10","60","0","0","4","0","1","0","196","29.10.12"
"460399","126","Львівська область","школа, актовий зал
вул.Головатого, 1, с.Подорожнє, Жидачівський р-н, Львівська обл., 81784","378","118","375","33","228","32","260","","0","228","32","260","3","257","0","24","79","12","86","0","1","3","0","0","0","52","29.10.12"
"460400","126","Львівська область","Народний дім, актовий зал
вул.Зелена, 29, с.Крехів, Жидачівський р-н, Львівська обл., 81790","126","26","124","23","81","19","100","","0","81","19","100","1","99","0","3","48","4","36","0","0","0","0","0","0","8","29.10.12"
"460401","126","Львівська область","Народний дім, актовий зал
вул.Шевченка, 5, с.Сидорівка, Жидачівський р-н, Львівська обл., 81790","186","53","181","15","118","15","133","","0","118","15","133","3","130","0","7","50","6","53","0","0","1","0","0","0","13","29.10.12"
"460402","126","Львівська область","школа, спортзал
вул.Шевченка, 31, с.Сулятичі, Жидачівський р-н, Львівська обл., 81791","390","103","387","43","246","41","287","","0","246","41","287","4","283","2","2","133","16","96","0","2","2","0","0","1","29","29.10.12"
"460403","126","Львівська область","школа, актовий зал
вул.Смердова, 15, с.Мельнич, Жидачівський р-н, Львівська обл., 81785","330","103","326","18","210","17","227","","0","210","17","227","4","223","0","2","106","12","53","1","1","7","0","3","1","37","29.10.12"
"460404","126","Львівська область","магазин, торговий зал
вул.Шкільна, 13А, с.Лютинка, Жидачівський р-н, Львівська обл., 81785","156","41","160","5","110","5","115","","0","110","5","115","1","114","0","5","51","5","38","1","0","0","0","1","0","13","29.10.12"
"460405","126","Львівська область","школа, к.2
вул.Л.Українки, 4, с.Буянів, Жидачівський р-н, Львівська обл., 81792","246","52","246","20","174","20","194","","0","174","20","194","1","193","0","2","109","7","60","1","0","1","0","1","0","12","29.10.12"
"460406","126","Львівська область","школа, к.1
вул.Б.Хмельницького, 10, с.Старе Село, Жидачівський р-н, Львівська обл., 81794","426","114","425","36","278","34","312","","0","278","34","312","2","310","1","9","150","16","82","0","0","3","2","1","1","45","29.10.12"
"460407","126","Львівська область","школа, фойє
вул.Центральна, 1, с.Монастирець, Жидачівський р-н, Львівська обл., 81792","696","204","687","52","446","46","492","","0","446","46","492","7","485","0","2","215","22","165","14","1","2","0","4","2","58","30.10.12"
"460408","126","Львівська область","школа, к.1
вул.Зелена, 1, с.Которини, Жидачівський р-н, Львівська обл., 81792","192","69","200","20","104","19","123","","0","104","19","123","0","123","0","6","80","10","21","0","0","1","0","0","0","5","29.10.12"
"460409","126","Львівська область","школа, к.1
вул.Садова, 40, с.Протеси, Жидачівський р-н, Львівська обл., 81793","414","144","416","43","227","43","270","","0","227","43","270","5","265","1","0","190","22","39","2","0","2","0","2","1","6","29.10.12"
"460410","126","Львівська область","Народний дім, актовий зал
вул.Першотравнева, 27, с.Зарічне, Жидачівський р-н, Львівська обл., 81795","480","138","483","34","310","32","342","","0","310","32","342","11","331","0","4","127","19","126","0","0","2","0","11","0","42","29.10.12"
"460411","126","Львівська область","Народний дім, актовий зал
вул.Підгірна, 8, с.Демівка, Жидачівський р-н, Львівська обл., 81796","36","12","33","12","15","9","24","","0","15","9","24","0","24","0","0","16","3","5","0","0","0","0","0","0","0","29.10.12"
"460412","126","Львівська область","фельдшерсько-акушерський пункт, кімната прийому хворих
вул.Довга, 8, с.Корчівка, Жидачівський р-н, Львівська обл., 81796","180","48","180","20","113","19","132","","0","113","19","132","1","131","0","6","97","6","17","0","0","0","0","3","0","2","29.10.12"
"460413","126","Львівська область","школа, спортзал
вул.Й.Ключика, 17, с.Лисків, Жидачівський р-н, Львівська обл., 81796","480","164","475","51","268","48","316","","0","268","48","316","4","312","1","6","146","11","25","0","0","0","0","117","0","6","29.10.12"
"460414","126","Львівська область","Народний дім, актовий зал
вул.В.Чорновола, 24, с.Дубравка, Жидачівський р-н, Львівська обл., 81798","246","80","243","21","150","16","166","","0","150","16","166","4","162","1","10","57","6","33","0","0","2","0","4","0","49","29.10.12"
"460415","126","Львівська область","Народний дім, актовий зал
вул.Центральна, 9А, с.Тернавка, Жидачівський р-н, Львівська обл., 81798","132","39","130","18","75","18","93","","0","75","18","93","1","92","0","3","46","3","34","1","0","1","0","1","0","3","29.10.12"
"460416","126","Львівська область","Народний дім, актовий зал
вул.Центральна, 97А, с.Чертіж, Жидачівський р-н, Львівська обл., 81798","384","92","391","39","253","39","292","","0","253","39","292","8","284","0","8","148","20","93","2","0","2","0","3","0","8","29.10.12"
"460417","126","Львівська область","Жидачівська ЦРЛ, конференц-зал
вул.Я.Мудрого, 29, м.Жидачів, Жидачівський р-н, Львівська обл., 81700","186","169","22","18","4","13","17","","0","4","13","17","0","17","0","0","6","1","8","0","1","0","0","0","0","1","29.10.12"
"460418","126","Львівська область","Ходорівська районна лікарня, актовий зал
вул.Б.Хмельницького, 63, м.Ходорів, Жидачівський р-н, Львівська обл., 81750","168","141","36","12","17","10","27","","0","17","10","27","0","27","0","1","12","2","11","1","0","0","0","0","0","0","29.10.12"
"461436","126","Львівська область","будинок культури, актовий зал, к.2
вул.Шевченка, 7, смт Дашава, Стрийський р-н, Львівська обл., 82443","1812","552","1797","48","1212","48","1260","","0","1212","48","1260","12","1248","4","48","527","49","223","3","0","63","3","11","2","315","29.10.12"
"461437","126","Львівська область","приватний житловий будинок, к.2
вул.Стрийська, 13, с.Гайдучина, Стрийський р-н, Львівська обл., 82443","198","41","197","5","152","5","157","","0","152","5","157","3","154","0","12","101","5","13","0","0","2","0","0","0","21","29.10.12"
"461438","126","Львівська область","будинок культури, актовий зал, к.2
вул.І.Франка, 65, с.Олексичі, Стрийський р-н, Львівська обл., 82442","480","115","479","21","344","21","365","","0","344","21","365","4","361","0","14","179","19","82","2","0","14","0","2","1","48","29.10.12"
"461439","126","Львівська область","будинок культури, актовий зал, к.2
пл.Незалежності, 4, с.Братківці, Стрийський р-н, Львівська обл., 82465","1080","258","1062","42","780","42","822","","0","780","42","822","13","809","1","5","215","35","279","2","0","22","1","3","2","244","29.10.12"
"461440","126","Львівська область","будинок культури, актовий зал, к.2
вул.Незалежності, 28, с.Вівня, Стрийський р-н, Львівська обл., 82425","534","128","525","11","395","11","406","","0","395","11","406","9","397","1","1","83","18","111","3","1","12","0","1","1","165","29.10.12"
"461441","126","Львівська область","школа, спортивний зал, к.2
вул.І.Франка, 26, с.Воля-Задеревацька, Стрийський р-н, Львівська обл., 82489","654","96","642","18","540","18","558","","0","540","18","558","14","544","0","4","208","37","107","0","1","17","0","1","0","169","29.10.12"
"461442","126","Львівська область","будинок культури, актовий зал, к.2
вул.Л.Українки, 10, с.Задеревач, Стрийський р-н, Львівська обл., 82487","438","78","438","18","342","18","360","","0","342","18","360","6","354","1","2","194","23","60","2","0","2","0","0","0","70","29.10.12"
"461443","126","Львівська область","будинок культури, актовий зал, к.2
вул.Шевченка, 227, с.Гірне, Стрийський р-н, Львівська обл., 82468","1326","275","1315","51","1002","49","1051","","0","1002","49","1051","15","1036","3","5","277","31","136","3","2","31","0","5","2","541","29.10.12"
"461444","126","Львівська область","будинок культури, актовий зал, к.2
вул.Зарічна, 2А, с.Голобутів, Стрийський р-н, Львівська обл., 82432","732","169","725","59","506","57","563","","0","506","57","563","10","553","1","11","238","29","64","1","0","16","0","5","0","188","29.10.12"
"461445","126","Львівська область","будинок культури, актовий зал, к.2
вул.Лопатинського, 119Б, с.Грабовець, Стрийський р-н, Львівська обл., 82435","834","184","820","42","610","40","650","","0","610","40","650","9","641","0","1","307","29","64","3","0","43","1","2","1","190","29.10.12"
"461446","126","Львівська область","будинок культури, актовий зал, к.2
вул.Гошівська, 73, с.Великі Дідушичі, Стрийський р-н, Львівська обл., 82484","1344","309","1326","41","994","41","1035","","0","994","41","1035","13","1022","1","14","708","31","55","0","0","14","1","1","2","195","29.10.12"
"461447","126","Львівська область","будинок культури, актовий зал, к.2
вул.Шевченка, 96, с.Малі Дідушичі, Стрийський р-н, Львівська обл., 82485","612","148","603","40","425","39","464","","0","425","39","464","5","459","1","0","365","31","19","0","1","2","0","0","1","39","29.10.12"
"461448","126","Львівська область","будинок культури, актовий зал, к.2
вул.Осипенка, 2, с.Угільня, Стрийський р-н, Львівська обл., 82484","318","42","313","12","264","12","276","","0","264","12","276","1","275","0","3","203","9","11","1","0","3","0","1","1","43","29.10.12"
"461449","126","Львівська область","будинок культури, актовий зал, к.2
вул.Довга, 99, с.Добрівляни, Стрийський р-н, Львівська обл., 82426","738","255","731","27","459","24","483","","0","459","24","483","6","477","1","9","134","12","75","1","1","23","0","0","3","218","29.10.12"
"461450","126","Львівська область","будинок культури, актовий зал, к.2
вул.Шевченка, 32, с.Добряни, Стрийський р-н, Львівська обл., 82427","1458","310","1454","16","1133","15","1148","","0","1133","15","1148","15","1133","5","6","203","26","188","3","0","59","0","2","0","641","29.10.12"
"461451","126","Львівська область","будинок культури, актовий зал, к.2
вул.Миру, 97, с.Воля-Довголуцька, Стрийський р-н, Львівська обл., 82453","330","69","328","12","249","12","261","","0","249","12","261","7","254","0","3","150","25","40","0","0","4","0","0","0","32","29.10.12"
"461452","126","Львівська область","будинок культури, актовий зал, к.2
пл.Перемоги, 7, с.Довголука, Стрийський р-н, Львівська обл., 82453","630","165","621","28","441","24","465","","0","441","24","465","18","447","2","11","236","31","107","0","0","11","0","1","0","48","29.10.12"
"461453","126","Львівська область","будинок культури, актовий зал, к.2
вул.Стрийська, 4, с.Верхня Лукавиця, Стрийський р-н, Львівська обл., 82481","300","59","293","18","224","17","241","","0","224","17","241","4","237","0","4","47","9","38","0","0","9","0","2","1","127","29.10.12"
"461454","126","Львівська область","школа, спортивний зал, к.2
вул.Болехівська, 14, с.Горішнє, Стрийський р-н, Львівська обл., 82481","234","41","234","11","183","10","193","","0","183","10","193","0","193","0","6","100","12","20","2","0","11","1","1","0","40","29.10.12"
"461455","126","Львівська область","сільська рада, зал засідань, к.2
пров.Багнянський, 2, с.Долішнє, Стрийський р-н, Львівська обл., 82480","450","108","445","21","321","21","342","","0","321","21","342","7","335","0","5","127","18","90","0","0","4","0","3","0","88","29.10.12"
"461456","126","Львівська область","школа, спортивний зал, к.2
вул.Л.України, 45, с.Нижня Лукавиця, Стрийський р-н, Львівська обл., 82480","288","64","288","15","210","14","224","","0","210","14","224","3","221","0","5","51","11","52","0","0","1","2","0","1","98","29.10.12"
"461457","126","Львівська область","будинок культури, актовий зал, к.2
вул.Заводська, 24, с.Дуліби, Стрийський р-н, Львівська обл., 82434","1464","428","1455","55","988","48","1036","","0","988","48","1036","11","1025","2","0","423","40","144","19","0","169","0","3","0","225","29.10.12"
"461458","126","Львівська область","школа-сад, спортивний зал, к.2
вул.Шевченка, 127, с.Дуліби, Стрийський р-н, Львівська обл., 82434","1440","512","1423","34","895","33","928","","0","895","33","928","12","916","1","5","348","21","176","8","0","77","0","7","7","266","29.10.12"
"461459","126","Львівська область","будинок культури, актовий зал, к.2
вул.Миру, 12, с.Жулин, Стрийський р-н, Львівська обл., 82470","744","164","742","37","546","34","580","","0","546","34","580","11","569","0","5","181","13","121","1","1","13","0","1","0","233","29.10.12"
"461460","126","Львівська область","школа, спортивний зал, к.2
вул.Т.Шевченка, 12, с.Завадів, Стрийський р-н, Львівська обл., 82433","900","206","896","42","654","40","694","","0","654","40","694","10","684","2","9","461","30","65","0","0","18","0","0","0","99","29.10.12"
"461461","126","Львівська область","будинок культури, актовий зал, к.2
вул.Шевченка, 2, с.Загірне, Стрийський р-н, Львівська обл., 82446","1020","290","1007","35","698","32","730","","0","698","32","730","9","721","2","78","316","26","141","3","0","23","0","3","3","126","29.10.12"
"461462","126","Львівська область","школа, к.6
вул.Польова, 7, с.Заплатин, Стрийский р-н, Львівська обл., 82400","114","29","109","0","85","0","85","","0","85","0","85","2","83","0","2","27","4","7","0","0","6","0","1","0","36","29.10.12"
"461463","126","Львівська область","будинок культури, актовий зал, к.2
вул.Нова, 16, с.Заплатин, Стрийський р-н, Львівська обл., 82400","408","100","399","18","290","18","308","","0","290","18","308","5","303","1","4","135","14","22","2","0","18","0","4","0","103","29.10.12"
"461464","126","Львівська область","будинок культури, актовий зал, к.2
вул.Шевченка, 113, с.Йосиповичі, Стрийський р-н, Львівська обл., 82445","696","93","685","33","570","33","603","","0","570","33","603","7","596","1","12","420","22","49","0","0","17","0","0","1","74","29.10.12"
"461465","126","Львівська область","сільська рада, зал засідань, к.2
вул.Стрийська, 5, с.Кавське, Стрийський р-н, Львівська обл., 82420","1092","388","1076","24","680","24","704","","0","680","24","704","14","690","4","9","334","40","128","0","1","17","0","4","3","150","29.10.12"
"461466","126","Львівська область","будинок культури, актовий зал, к.2
вул.Медична, 3, с.Колодниця, Стрийський р-н, Львівська обл., 82436","246","53","243","14","179","14","193","","0","179","14","193","4","189","1","6","128","4","33","0","0","3","0","0","0","14","29.10.12"
"461467","126","Львівська область","школа, к.2
вул.Гасина, 108, с.Конюхів, Стрийський р-н, Львівська обл., 82436","678","156","672","29","500","22","522","","0","500","22","522","9","513","0","3","228","29","119","1","0","22","0","1","0","110","29.10.12"
"461468","126","Львівська область","школа, спортивний зал, к.2
вул.Миру, 11, с.Ланівка, Стрийський р-н, Львівська обл., 82430","918","275","906","31","616","27","643","","0","616","27","643","14","629","2","28","240","34","147","3","0","10","2","3","0","160","29.10.12"
"461469","126","Львівська область","будинок культури, актовий зал, к.2
вул.Шкільна, 15, с.Баня Лисовицька, Стрийський р-н, Львівська обл., 82488","1380","377","1365","23","980","23","1003","","0","980","23","1003","20","983","1","3","389","39","171","4","0","16","1","7","5","347","29.10.12"
"461470","126","Львівська область","будинок культури, актовий зал, к.2
вул.Івана Франка, 34, с.Лисовичі, Стрийський р-н, Львівська обл., 82486","936","249","927","19","668","19","687","","0","668","19","687","5","682","0","7","356","22","95","0","0","7","5","1","2","187","29.10.12"
"461471","126","Львівська область","будинок культури, актовий зал, к.2
вул.Зелена, 17, с.Кути, Стрийський р-н, Львівська обл., 82421","312","77","306","18","220","15","235","","0","220","15","235","1","234","1","10","124","4","48","0","0","9","0","1","0","37","29.10.12"
"461472","126","Львівська область","сільська рада, зал засідань, к.2
пл.40-річчя Перемоги, 4, с.Лисятичі, Стрийський р-н, Львівська обл., 82421","1248","304","1236","71","882","62","944","","0","882","62","944","14","930","1","10","373","38","150","2","0","21","1","2","1","331","29.10.12"
"461473","126","Львівська область","будинок культури, актовий зал, к.2
вул.Л.Українки, 3, с.Луг, Стрийський р-н, Львівська обл., 82421","276","59","269","22","195","22","217","","0","195","22","217","3","214","1","9","96","13","36","1","0","2","1","0","0","55","29.10.12"
"461474","126","Львівська область","будинок культури, актовий зал, к.2
вул.Грушевського, 15, с.Пукеничі, Стрийський р-н, Львівська обл., 82422","438","79","435","22","337","22","359","","0","337","22","359","8","351","0","1","137","19","66","1","0","9","0","2","0","116","29.10.12"
"461475","126","Львівська область","будинок культури, актовий зал, к.2
вул.Шевченка, 13, с.Любинці, Стрийський р-н, Львівська обл., 82456","750","114","744","40","598","38","636","","0","598","38","636","8","628","0","16","395","24","122","0","0","13","0","3","0","55","29.10.12"
"461476","126","Львівська область","приватний житловий будинок, к.2
вул.Івана Франка, 3А, с.Хромогорб, Стрийський р-н, Львівська обл., 82456","72","28","69","4","40","4","44","","0","40","4","44","2","42","0","1","23","2","10","0","0","2","0","0","1","3","29.10.12"
"461477","126","Львівська область","будинок культури, актовий зал, к.2
вул.Шевченка, 6, с.Миртюки, Стрийський р-н, Львівська обл., 82463","750","208","739","45","502","40","542","","0","502","40","542","11","531","0","9","195","16","71","1","0","26","1","8","0","204","29.10.12"
"461478","126","Львівська область","будинок культури, актовий зал, к.2
вул.Колесси, 17, с.Слобідка, Стрийський р-н, Львівська обл., 82462","588","145","586","15","428","15","443","","0","428","15","443","4","439","1","5","216","24","32","0","0","14","0","1","2","144","29.10.12"
"461479","126","Львівська область","будинок культури, актовий зал, к.2
вул.Стрийська, 16, с.Монастирець, Стрийський р-н, Львівська обл., 82453","276","63","274","10","204","9","213","","0","204","9","213","2","211","0","1","90","11","68","0","0","4","0","0","0","37","29.10.12"
"461480","126","Львівська область","будинок культури, актовий зал, к.2
вул.І.Франка, 41А, с.Нежухів, Стрийський р-н, Львівська обл., 82431","1590","440","1573","22","1128","22","1150","","0","1128","22","1150","16","1134","1","4","885","51","63","1","0","15","0","5","3","106","29.10.12"
"461481","126","Львівська область","цегельний завод, к.2
вул.Миру, 42, с.Райлів, Стрийський р-н, Львівська обл., 82430","264","71","261","8","185","8","193","","0","185","8","193","3","190","1","0","125","10","13","1","1","9","0","2","1","27","28.10.12"
"461482","126","Львівська область","будинок культури, актовий зал, к.2
вул.Зарічна, 2, с.Нижня Стинава, Стрийський р-н, Львівська обл., 82455","792","189","783","69","534","69","603","","0","534","69","603","13","590","0","11","284","29","101","0","1","15","0","2","1","146","29.10.12"
"461483","126","Львівська область","школа, к.3
вул.Стрийська, 64, с.Верчани, Стрийський р-н, Львівська обл., 82441","1200","364","1188","27","812","24","836","","0","812","24","836","22","814","1","36","325","41","165","4","1","66","0","7","0","168","29.10.12"
"461484","126","Львівська область","школа, к.2
вул.І.Франка, 103, с.Комарів, Стрийський р-н, Львівська обл., 82440","324","87","316","14","225","12","237","","0","225","12","237","7","230","0","21","123","14","37","2","0","2","0","1","0","30","29.10.12"
"461485","126","Львівська область","школа, актовий зал, к.2
вул.Стрийська, 8А, с.Підгірці, Стрийський р-н, Львівська обл., 82440","660","116","653","23","521","23","544","","0","521","23","544","6","538","0","57","222","28","85","1","1","8","0","2","1","133","29.10.12"
"461486","126","Львівська область","будинок культури, актовий зал, к.2
вул.Сонячна, 20, с.Ярушичі, Стрийський р-н, Львівська обл., 82440","168","26","166","3","139","3","142","","0","139","3","142","1","141","0","9","65","9","28","0","0","12","0","0","0","18","29.10.12"
"461487","126","Львівська область","будинок культури, актовий зал, к.2
вул.Шевченка, 16, с.Зарічне, Стрийський р-н, Львівська обл., 82451","336","107","325","0","229","0","229","","0","229","0","229","9","220","1","2","70","14","36","0","0","0","0","0","0","97","28.10.12"
"461488","126","Львівська область","будинок культури, актовий зал, к.2
вул.Шевченка, 73, с.Лани-Соколівські, Стрийський р-н, Львівська обл., 82452","486","153","478","23","310","23","333","","0","310","23","333","9","324","1","16","165","17","56","1","0","6","0","2","1","59","29.10.12"
"461489","126","Львівська область","будинок культури, актовий зал, к.2
вул.8-го Березня, 1, с.Подорожнє, Стрийський р-н, Львівська обл., 82450","786","192","781","22","572","22","594","","0","572","22","594","8","586","1","17","232","28","153","1","0","11","0","0","1","142","29.10.12"
"461490","126","Львівська область","будинок культури, актовий зал, к.2
вул.Шевченка, 22, с.П’ятничани, Стрийський р-н, Львівська обл., 82423","696","98","691","28","571","27","598","","0","571","27","598","13","585","1","4","195","20","87","0","1","16","0","3","0","258","29.10.12"
"461491","126","Львівська область","будинок культури, актовий зал, к.2
вул.Стрийська, 61, с.Розгірче, Стрийський р-н, Львівська обл., 82472","426","115","417","22","290","21","311","","0","290","21","311","2","309","0","3","140","12","36","0","1","9","1","0","0","107","29.10.12"
"461492","126","Львівська область","будинок культури, актовий зал, к.2
вул.І.Франка, 67, с.Семигинів, Стрийський р-н, Львівська обл., 82471","846","193","840","40","614","39","653","","0","614","39","653","12","641","0","11","140","28","166","0","0","11","0","2","0","283","29.10.12"
"461493","126","Львівська область","будинок культури, актовий зал, к.2
вул.І.Франка, 106, с.Сихів, Стрийський р-н, Львівська обл., 82447","606","186","600","51","374","46","420","","0","374","46","420","17","403","1","19","171","29","98","0","0","12","2","1","1","69","29.10.12"
"461494","126","Львівська область","будинок культури, актовий зал, к.2
вул.І.Франка, 4, с.Довге, Стрийський р-н, Львівська обл., 82466","942","262","933","31","650","30","680","","0","650","30","680","11","669","0","10","317","39","70","1","0","6","1","2","1","222","29.10.12"
"461495","126","Львівська область","будинок культури, актовий зал, к.2
вул.В.Великого, 2, с.Станків, Стрийський р-н, Львівська обл., 82464","762","201","725","30","533","28","561","","0","533","28","561","10","551","0","5","279","24","123","0","0","12","1","2","0","105","28.10.12"
"461496","126","Львівська область","будинок культури, актовий зал, к.2
вул.І.Франка, 2, с.Фалиш, Стрийський р-н, Львівська обл., 82467","546","176","530","10","360","10","370","","0","360","10","370","4","366","1","6","222","20","48","0","0","12","0","1","0","56","01.11.12"
"461497","126","Львівська область","будинок культури, актовий зал, к.2
вул.І.Франка, 70, с.Верхня Стинава, Стрийський р-н, Львівська обл., 82454","750","257","741","61","434","59","493","","0","434","59","493","6","487","2","2","235","27","113","1","0","25","5","2","1","74","29.10.12"
"461498","126","Львівська область","будинок культури, актовий зал, к.2
вул.Миру, 65, с.Стриганці, Стрийський р-н, Львівська обл., 82429","414","82","412","18","314","18","332","","0","314","18","332","7","325","0","3","167","24","38","0","0","3","0","0","0","90","29.10.12"
"461499","126","Львівська область","будинок культури, актовий зал, к.2
вул.Січових Стрільців, 26, с.Бережниця, Стрийський р-н, Львівська обл., 82461","468","107","467","16","345","16","361","","0","345","16","361","20","341","0","8","150","16","68","0","0","18","0","2","1","78","29.10.12"
"461500","126","Львівська область","будинок культури, актовий зал, к.2
вул.Шевченка, 1, с.Лотатники, Стрийський р-н, Львівська обл., 82460","264","69","261","12","183","12","195","","0","183","12","195","0","195","0","2","36","8","112","0","0","9","0","0","0","28","29.10.12"
"461501","126","Львівська область","будинок культури, актовий зал, к.2
вул.І.Франка, 75, с.Стрілків, Стрийський р-н, Львівська обл., 82460","995","141","987","29","827","27","854","","0","827","27","854","8","846","1","12","431","44","130","2","0","13","0","3","3","207","29.10.12"
"461502","126","Львівська область","будинок культури, актовий зал, к.2
вул.Івана Франка, 35, с.Угерсько, Стрийський р-н, Львівська обл., 82424","1338","282","1328","46","1012","44","1056","","0","1012","44","1056","12","1044","0","2","482","48","202","2","0","40","0","2","2","264","29.10.12"
"461503","126","Львівська область","будинок культури, актовий зал, к.2
вул.Колесси, 5, с.Піщани, Стрийський р-н, Львівська обл., 82428","372","64","369","14","294","14","308","","0","294","14","308","1","307","0","9","194","9","29","0","1","6","0","1","0","58","29.10.12"
"461504","126","Львівська область","сільська рада, зал засідань, к.2
вул.Миру, 5, с.Ходовичі, Стрийський р-н, Львівська обл., 82428","726","183","721","18","525","18","543","","0","525","18","543","11","532","2","20","292","19","102","1","2","8","0","2","0","84","29.10.12"
"461744","126","Львівська область","школа-ліцей, актова зала, 1-й поверх
вул.Лесі Українки, 36, м.Моршин, Львівська обл., 82482","1890","767","1864","18","1106","17","1123","","0","1106","17","1123","15","1108","5","22","316","31","206","5","2","46","5","11","14","445","29.10.12"
"461745","126","Львівська область","Палац культури, мала зала, 1-й поверх
вул.І.Франка, 52, м.Моршин, Львівська обл., 82482","1962","713","1938","25","1231","18","1249","","0","1231","18","1249","21","1228","12","44","421","45","217","3","1","39","1","25","20","400","29.10.12"
"461779","126","Львівська область","Стрийський коледж Львівського національного аграрного університету, корпус №3, к.5
вул.Галицька, 9, м.Стрий, Львівська обл., 82400","2094","852","2082","20","1222","20","1242","","0","1222","20","1242","16","1226","1","14","475","48","172","6","0","64","1","8","9","428","29.10.12"
"461780","126","Львівська область","вище професійне училище №35, актова зала
вул.Львівська, 141, м.Стрий, Львівська обл., 82400","2382","955","2372","12","1418","9","1427","","0","1418","9","1427","12","1415","5","16","594","54","157","6","1","75","3","8","14","482","29.10.12"
"461781","126","Львівська область","філія Інституту підприємництва та перспективних технологій НУ ""Львівська політехніка"", ауд.207
вул.Січових Стрільців, 12В, м.Стрий, Львівська обл., 82400","1878","705","1869","15","1162","11","1173","","0","1162","11","1173","19","1154","3","16","443","45","195","5","1","57","1","6","24","358","30.10.12"
"461782","126","Львівська область","філія Центру творчості дітей та юнацтва, актова зала
вул.Сковороди, 6В, м.Стрий, Львівська обл., 82400","2370","818","2351","8","1548","4","1552","","0","1548","4","1552","20","1532","0","14","563","47","239","5","1","82","0","15","15","551","29.10.12"
"461783","126","Львівська область","школа №3, актова зала
вул.50-річчя УПА, 2, м.Стрий, Львівська обл., 82400","2070","806","2036","26","1244","20","1264","","0","1244","20","1264","22","1242","6","28","499","52","168","4","0","76","2","12","32","363","29.10.12"
"461784","126","Львівська область","школа №10, фойє
вул.Красівського, 31, м.Стрий, Львівська обл., 82400","2100","862","2087","17","1223","15","1238","","0","1223","15","1238","25","1213","1","19","416","53","190","3","1","62","2","9","21","436","29.10.12"
"461785","126","Львівська область","Будинок учнівської творчості, танцювальна зала
вул.Красівського, 28, м.Стрий, Львівська обл., 82400","1374","523","1382","29","822","29","851","","0","822","29","851","21","830","1","12","333","30","89","5","0","58","1","6","23","272","29.10.12"
"461786","126","Львівська область","Стрийська дорожно-експлуатаційна дільниця, к.1
вул.Добрівлянська, 41, м.Стрий, Львівська обл., 82400","1674","578","1656","15","1082","14","1096","","0","1082","14","1096","14","1082","1","11","386","40","155","1","1","47","2","10","7","421","29.10.12"
"461787","126","Львівська область","школа №11, к.20-21
вул.Січових Стрільців, 12Б, м.Стрий, Львівська обл., 82400","1308","506","1302","18","790","12","802","","0","790","12","802","13","789","3","18","294","29","125","7","1","41","3","4","18","246","29.10.12"
"461788","126","Львівська область","хорова школа ""Щедрик"", актова зала
вул.Хмельницького, 27, м.Стрий, Львівська обл., 82400","2184","764","2223","9","1413","7","1420","","0","1413","7","1420","21","1399","5","24","572","56","240","2","1","63","0","8","22","406","29.10.12"
"461789","126","Львівська область","школа №1, приміщення початкових класів, к.1
вул.Мазепи, 7, м.Стрий, Львівська обл., 82400","1404","552","1404","31","826","26","852","","0","826","26","852","16","836","4","20","254","27","128","4","1","52","1","12","39","294","29.10.12"
"461790","126","Львівська область","школа №2, спортивна зала, 2-й поверх
вул.Шевченка, 70, м.Стрий, Львівська обл., 82400","1800","661","1776","31","1112","27","1139","","0","1112","27","1139","17","1122","3","23","412","35","170","3","0","49","2","10","38","377","29.10.12"
"461791","126","Львівська область","міжшкільний навчально-виробничий комбінат, клас безпеки дорожнього руху
вул.Бандери, 51, м.Стрий, Львівська обл., 82400","1884","749","1849","20","1119","16","1135","","0","1119","16","1135","25","1110","6","27","374","37","181","1","0","54","3","9","28","390","29.10.12"
"461792","126","Львівська область","будинок працівників освіти м.Стрия, актова зала
вул.Бобикевича, 5, м.Стрий, Львівська обл., 82400","1866","682","1851","25","1163","21","1184","","0","1163","21","1184","25","1159","4","36","394","37","164","4","0","65","3","15","63","374","29.10.12"
"461793","126","Львівська область","школа №7, спортивна зала
вул.Колесси, 12, м.Стрий, Львівська обл., 82400","1680","709","1670","24","949","22","971","","0","949","22","971","20","951","1","33","342","42","134","5","0","57","1","11","35","290","29.10.12"
"461794","126","Львівська область","дитяча музична школа ім.О.Нижанківського, актова зала
вул.Валова, 11, м.Стрий, Львівська обл., 82400","1734","685","1738","32","1017","32","1049","","0","1017","32","1049","26","1023","3","41","369","41","165","1","1","46","3","10","26","317","29.10.12"
"461795","126","Львівська область","міський Будинок культури, глядацька зала
вул.Крушельницької, 18, м.Стрий, Львівська обл., 82400","2208","860","2168","32","1319","29","1348","","0","1319","29","1348","21","1327","3","34","528","55","175","3","3","69","1","11","53","392","29.10.12"
"461796","126","Львівська область","школа №8, фойє
вул.Вузька, 9, м.Стрий, Львівська обл., 82400","1476","584","1469","20","875","17","892","","0","875","17","892","16","876","1","22","319","29","164","1","0","38","2","8","44","248","29.10.12"
"461797","126","Львівська область","Стрийське управління підземного зберігання газу УМГ ""Львівтрансгаз"", актова зала, 2-й поверх
вул.Сколівська, 3, м.Стрий, Львівська обл., 82400","1788","720","1755","16","1054","14","1068","","0","1054","14","1068","26","1042","7","68","354","37","178","6","0","49","3","14","37","289","29.10.12"
"461798","126","Львівська область","ЖЕК №4, актова зала
вул.Харкова, 6, м.Стрий, Львівська обл., 82400","1482","611","1457","18","859","12","871","","0","859","12","871","18","853","8","60","262","30","184","1","2","38","4","7","79","178","29.10.12"
"461799","126","Львівська область","школа №9, спортивна зала
вул.Грабовецька, 23, м.Стрий, Львівська обл., 82400","1482","697","1468","8","777","8","785","","0","777","8","785","23","762","4","40","324","30","113","3","1","29","6","5","32","175","29.10.12"
"461800","126","Львівська область","Будинок просвіти Храму Всіх Святих Українського Народу, їдальня
вул.Виговського, 8, м.Стрий, Львівська обл., 82400","1506","726","1489","9","773","7","780","","0","773","7","780","20","760","3","21","321","26","132","3","0","27","1","8","24","194","29.10.12"
"461801","126","Львівська область","філія Стрийського ""Райавтодору"", актова зала, 2-й поверх
вул.Дрогобицька, 68, м.Стрий, Львівська обл., 82400","1146","427","1152","29","694","25","719","","0","694","25","719","18","701","0","12","266","33","91","0","0","24","0","5","6","264","28.10.12"
"461802","126","Львівська область","ЕЧ-8, актова зала, 2-й поверх
вул.Петлюри, 3, м.Стрий, Львівська обл., 82400","1272","389","1265","31","855","28","883","","0","855","28","883","20","863","1","5","203","22","84","2","0","22","1","6","3","514","29.10.12"
"461803","126","Львівська область","Державне підприємство ""Стрийський вагоноремонтний завод"", адмінкорпус, актова зала
вул.Зубенка, 2, м.Стрий, Львівська обл., 82400","1956","605","1956","26","1328","23","1351","","0","1328","23","1351","24","1327","2","20","342","30","124","3","1","70","1","15","30","689","29.10.12"
"461804","126","Львівська область","Стрийська центральна районна лікарня, зал засідань
вул.О.Басараб, 15, м.Стрий, Львівська обл., 82400","156","108","77","20","37","11","48","","0","37","11","48","0","48","0","1","21","1","7","0","0","0","0","2","2","14","29.10.12"
"461805","126","Львівська область","Стрийський пологовий будинок, 4-й поверх, фойє
вул.Шашкевича, 17, м.Стрий, Львівська обл., 82400","55","29","27","0","26","0","26","","0","26","0","26","0","26","0","0","11","1","6","0","0","2","0","0","2","4","29.10.12"
"461806","126","Львівська область","дорожна лікарня № 2 станції ""Стрий"", фітобар
вул.Петлюри, 72, м.Стрий, Львівська обл., 82400","53","33","23","2","18","2","20","","0","18","2","20","1","19","0","1","4","1","7","0","0","0","0","0","2","4","29.10.12"
"461807","126","Львівська область","Стрийська центральна міська лікарня, кабінет рентгенолога
вул.Дрогобицька, 50, м.Стрий, Львівська обл., 82400","102","60","54","10","32","10","42","","0","32","10","42","0","42","0","1","10","2","6","1","0","2","0","2","2","16","29.10.12"
