"№ ВД","OBO","Назва регіону України","Місцезнаходження та адреса приміщення для голосування","1) К-сть одержаних бюлетенів","2) К-сть невикористаних бюлетенів","3) К-сть виборців, внесених до списку виборців","4) К-сть виборців, внесених до витягу зі списку виборців","5) К-сть виборців, які отримали бюлетені у приміщенні","6) К-сть виборців, які отримали за місцем перебування","7) Сумарна к-сть виборців, які отримали бюлетені","8) К-сть бюлетенів, що виявилися у кожній скринці","9) К-сть бюлетенів, що не підлягають врахуванню","10) К-сть виборців, які взяли участь у голос. у приміщенні для гол.","11) К-сть виборців, які взяли участь у голос. за місцем перебування","12) К-сть виборців, які взяли участь у голосуванні на виборчій дільниці","13) К-сть бюлетенів, визнаних недійсними","14) Сумарна к-сть голосів виборців ЗА","Гіршфельд
Анатолій
Мусійович","Мішуровська
Світлана
Тимофіївна","Петренко
Сергій
Миколайович","Полковниченко
Олександр
Миколайович","Тимошенко
Володимир
Миколайович","Ткаченко
Олександр
Іванович","Шахматенко
Сергій
Іванович","Ярещенко
Михайло
Євгенович","Дата підписання протоколу"
"630371","179","Харківська область","будинок культури, фойє
вул.Радянська, 46, смт Зачепилівка, Зачепилівський р-н, Харківська обл., 64401","1320","541","1273","66","723","56","779","","0","723","56","779","21","758","377","13","120","54","12","18","103","61","29.10.12"
"630372","179","Харківська область","ліцей, спортивна зала
вул.Радянська, 40, смт Зачепилівка, Зачепилівський р-н, Харківська обл., 64401","1440","588","1403","82","783","69","852","","0","783","69","852","25","827","386","13","146","81","7","17","102","75","29.10.12"
"630373","179","Харківська область","будинок культури, актова зала
вул.Жовтнева, 94, смт Зачепилівка, Зачепилівський р-н, Харківська обл., 64401","768","310","774","49","412","46","458","","0","412","46","458","16","442","238","11","89","16","9","9","40","30","29.10.12"
"630374","179","Харківська область","ТОВ ""Зачепилівське ХПП"", зала засідання
вул.Пушкіна, 33, с.Нагірне, Зачепилівський р-н, Харківська обл., 64408","680","277","671","60","349","54","403","","0","349","54","403","21","382","160","8","82","16","4","14","52","46","29.10.12"
"630375","179","Харківська область","амбулаторія сімейного лікаря, фойє
вул.Щорса, амбулаторія сімейного лікаря, с.Дудівка, Зачепилівський р-н, Харківська обл., 64451","216","55","211","42","122","39","161","","0","122","39","161","8","153","70","2","22","6","11","5","24","13","29.10.12"
"630376","179","Харківська область","школа, спортивна зала
вул.Леніна, школа, с.Нове Мажарове, Зачепилівський р-н, Харківська обл., 64450","736","239","719","68","434","63","497","","0","434","63","497","16","481","178","13","76","56","12","17","86","43","29.10.12"
"630377","179","Харківська область","СВК ""Заповіт Леніна"", зала засідання
вул.Вишнева, СВК ""Заповіт Леніна"", с.Старе Пекельне, Зачепилівський р-н, Харківська обл., 64454","440","144","424","42","255","41","296","","0","255","41","296","20","276","124","10","60","10","10","21","15","26","28.10.12"
"630378","179","Харківська область","сільська рада, зала засідання
вул.Леніна, сільська рада, с.Леб’яже, Зачепилівський р-н, Харківська обл., 64420","712","276","698","64","377","59","436","","0","377","59","436","19","417","244","10","34","30","15","21","38","25","29.10.12"
"630379","179","Харківська область","Філія ""Зачепилівський райавтодор"" ДП ""Харківський облавтодор"", фойє
вул.Будівельна, 1, с.Кочетівка, Зачепилівський р-н, Харківська обл., 64401","344","135","351","20","191","18","209","","0","191","18","209","6","203","90","4","35","20","6","2","16","30","29.10.12"
"630380","179","Харківська область","школа, спортивна зала
вул.Леніна, школа, с.Чернещина, Зачепилівський р-н, Харківська обл., 64410","600","218","599","68","321","61","382","","0","321","61","382","11","371","111","10","92","61","20","21","33","23","28.10.12"
"630381","179","Харківська область","будинок культури, фойє
вул.Жовтнева, будинок культури, с.Новоселівка, Зачепилівський р-н, Харківська обл., 64411","432","127","425","52","254","51","305","","0","254","51","305","18","287","136","9","55","16","15","6","33","17","29.10.12"
"630382","179","Харківська область","будинок культури, зал
вул.Радянська, будинок культури, с.Бердянка, Зачепилівський р-н, Харківська обл., 64440","640","216","628","70","359","65","424","","0","359","65","424","18","406","202","5","76","37","25","16","23","22","29.10.12"
"630383","179","Харківська область","АФ ТОВ ""Вибір"", зала засідання
вул.Молодіжна, АФ ТОВ ""Вибір"", с.Першотравневе, Зачепилівський р-н, Харківська обл., 64440","264","86","260","27","151","27","178","","0","151","27","178","8","170","99","3","26","8","11","6","3","14","29.10.12"
"630384","179","Харківська область","школа, спортивна зала
вул.Центральна, школа, с.Забарине, Зачепилівський р-н, Харківська обл., 64425","272","63","270","17","195","14","209","","0","195","14","209","6","203","130","4","17","16","1","3","16","16","28.10.12"
"630385","179","Харківська область","будинок культури, зал
вул.Котовського, будинок культури, с.Олександрівка, Зачепилівський р-н, Харківська обл., 64426","256","72","257","38","148","36","184","","0","148","36","184","7","177","91","1","29","19","5","2","21","9","29.10.12"
"630386","179","Харківська область","сільська рада, зала засідання
вул.Лермонтова, сільська рада, с.Малий Орчик, Зачепилівський р-н, Харківська обл., 64431","160","49","155","13","98","13","111","","0","98","13","111","6","105","66","3","7","6","1","4","10","8","29.10.12"
"630387","179","Харківська область","будинок культури, фойє
вул.ім.Карла Маркса, будинок культури, с.Залінійне, Зачепилівський р-н, Харківська обл., 64431","360","122","354","42","200","38","238","","0","200","38","238","14","224","92","6","26","20","17","8","32","23","29.10.12"
"630388","179","Харківська область","школа, спортивна зала
вул.Калініна, школа, с.Орчик, Зачепилівський р-н, Харківська обл., 64431","344","130","343","47","168","46","214","","0","168","46","214","6","208","92","2","14","14","4","7","39","36","29.10.12"
"630389","179","Харківська область","школа, спортивна зала
вул.Леніна, школа, с.Сомівка, Зачепилівський р-н, Харківська обл., 64433","456","164","440","56","243","49","292","","0","243","49","292","9","283","130","9","61","20","12","9","28","14","29.10.12"
"630390","179","Харківська область","ПСП ""Володимир"", зала засідання
вул.Козирєва, ПСП ""Володимир"", с.Семенівка, Зачепилівський р-н, Харківська обл., 64435","232","80","234","27","127","25","152","","0","127","25","152","3","149","78","6","22","10","10","3","6","14","28.10.12"
"630391","179","Харківська область","школа, спортивна зала
вул.Харківська, школа, с.Миколаївка, Зачепилівський р-н, Харківська обл., 64423","808","210","817","82","524","74","598","","0","524","74","598","16","582","255","14","67","85","12","17","88","44","29.10.12"
"630392","179","Харківська область","будинок культури, каб.2
вул.Центральна, будинок культури, с.Абазівка, Зачепилівський р-н, Харківська обл., 64424","336","126","329","28","184","26","210","","0","184","26","210","15","195","102","4","32","16","10","10","4","17","28.10.12"
"630393","179","Харківська область","вул.Петровського, школа, спортивна зала, с.Рунівщина, Зачепилівський р-н, Харківська обл., 64412
вул.Петровського, школа, спортивна зала, с.Рунівщина, Зачепилівський р-н, Харківська обл., 64412","600","200","590","46","357","43","400","","0","357","43","400","19","381","166","4","38","12","8","6","115","32","28.10.12"
"630394","179","Харківська область","вул.Жовтнева, с.Устимівка, Зачепилівський р-н, Харківська обл., 64413
вул.Жовтнева, с.Устимівка, Зачепилівський р-н, Харківська обл., 64413 (будинок культури, фойє)","184","66","179","22","98","20","118","","0","98","20","118","15","103","46","3","12","5","10","0","22","5","29.10.12"
"630498","179","Харківська область","школа, актовий зал
вул.Шкільна, 1А, с.Андріївка, Кегичівський р-н, Харківська обл., 64031","672","306","658","19","349","17","366","","0","349","17","366","14","352","130","8","36","47","12","24","10","85","28.10.12"
"630499","179","Харківська область","навчально-виховний комплекс, спортивний зал
вул.Шкільна, 2, с.Бессарабівка, Кегичівський р-н, Харківська обл., 64053","544","256","532","40","250","38","288","","0","250","38","288","14","274","115","15","38","59","11","4","10","22","29.10.12"
"630500","179","Харківська область","загальноосвітній навчально-виховний комплекс, фойє
вул.Каштанова, 26, с.Власівка, Кегичівський р-н, Харківська обл., 64010","496","179","488","56","269","48","317","","0","269","48","317","11","306","79","4","57","87","23","22","7","27","28.10.12"
"630501","179","Харківська область","школа, спортивний зал
вул.Центральна, школа, с.Вовківка, Кегичівський р-н, Харківськва обл., 64041","768","357","757","36","383","28","411","","0","383","28","411","20","391","166","12","61","63","25","14","9","41","29.10.12"
"630502","179","Харківська область","сільський клуб, фойє
вул.Ломоносова, 4, с.Антонівка, Кегичівський р-н, Харківська обл., 64003","160","42","157","7","111","7","118","","0","111","7","118","4","114","78","2","3","13","3","3","10","2","29.10.12"
"630503","179","Харківська область","ліцей, спортивний зал
вул.Волошина, 91, смт Кегичівка, Кегичівський р-н, Харківська обл., 64003","1616","798","1607","66","760","58","818","","0","760","58","818","28","790","385","30","102","102","25","34","51","61","29.10.12"
"630504","179","Харківська область","ПТУ-60, актовий зал
вул.Калініна, 30, смт Кегичівка, Кегичівський р-н, Харківська обл., 64003","1664","728","1621","45","897","39","936","","0","897","39","936","36","900","407","38","144","79","27","23","60","122","29.10.12"
"630505","179","Харківська область","будинок культури, фойє
вул.1-го Травня, 9, смт Кегичівка, Кегичівський р-н, Харківська обл., 64003","912","411","902","34","467","34","501","","0","467","34","501","13","488","253","17","73","47","11","16","31","40","29.10.12"
"630506","179","Харківська область","ПТУ-60, спортивний зал
вул.Калініна, 30, смт Кегичівка, Кегичівський р-н, Харківська обл., 64003","1200","596","1179","41","565","39","604","","0","565","39","604","33","571","236","20","92","72","21","21","31","78","29.10.12"
"630507","179","Харківська область","сільський клуб, фойє
вул.Шкільна, 3А, с-ще Красне, Кегичівський р-н, Харківської обл., 64032","1128","563","1111","78","496","69","565","","0","495","69","564","29","535","214","24","88","91","8","7","68","35","29.10.12"
"630508","179","Харківська область","сільський клуб, актовий зал
вул.Лозівська, 99, с.Лозова, Кегичівський р-н, Харківська обл., 64011","496","204","488","54","239","53","292","","0","239","53","292","11","281","103","3","41","67","4","9","42","12","29.10.12"
"630509","179","Харківська область","загальноосвітній навчально-виховний комплекс, кабінет української мови та історії
пров.Шкільний, 8, с.Мажарка, Кегичівський р-н, Харківська обл., 64040","568","217","551","38","315","36","351","","0","315","36","351","11","340","159","14","29","63","22","8","4","41","29.10.12"
"630510","179","Харківська область","школа, їдальня
вул.Шкільна, школа, с.Медведівка, Кегичівський р-н, Харківська обл., 64012","448","194","444","36","219","35","254","","0","219","35","254","13","241","107","9","30","44","7","7","12","25","29.10.12"
"630511","179","Харківська область","навчально-виховний комплекс, актовий зал
вул.Миру, 7А, с.Нова Парафіївка, Кегичівський р-н, Харківська обл., 64052","496","236","488","21","240","20","260","","0","240","20","260","16","244","79","24","29","57","9","14","19","13","28.10.12"
"630512","179","Харківська область","школа, фойє
вул.Шкільна, 1, с.Павлівка, Кегичівський р-н, Харківська обл., 64050","632","353","623","59","228","51","279","","0","228","51","279","15","264","118","19","26","32","12","18","15","24","29.10.12"
"630513","179","Харківська область","школа, фойє
вул.Йосипа Даценка, 102, с.Парасковія, Кегичівський р-н, Харківська обл., 64023","392","145","381","32","218","29","247","","0","218","29","247","12","235","95","6","33","45","9","4","16","27","28.10.12"
"630514","179","Харківська область","ПП ""Агропрогрес"", кабінет керуючого
вул.Шевченка, 12, с.Розсохувата, Кегичівський р-н, Харківська обл., 64009","360","132","352","25","206","22","228","","0","206","22","228","12","216","137","4","14","20","3","3","22","13","29.10.12"
"630515","179","Харківська область","сільська рада, зал урочистих подій
вул.Шевченка, 47А, с.Рояківка, Кегичівський р-н, Харківська обл., 64030","288","120","279","26","143","25","168","","0","143","25","168","6","162","71","3","32","32","1","5","10","8","28.10.12"
"630516","179","Харківська область","будинок культури, актовий зал
вул.Учительська, 2, с.Софіївка, Кегичівський р-н, Харківська обл., 64030","384","153","381","53","180","51","231","","0","180","51","231","9","222","108","7","17","36","3","9","16","26","29.10.12"
"630517","179","Харківська область","стара школа, фойє
вул.Радянська, 1, смт Чапаєве, Кегичівський р-н, Харківська обл., 64020","1304","685","1289","37","588","31","619","","0","588","31","619","39","580","307","19","75","85","13","11","18","52","29.10.12"
"630518","179","Харківська область","нова школа, фойє
вул.Радянська, 1, смт Чапаєве, Кегичівський р-н, Харківська обл., 64020","1624","742","1604","51","834","48","882","","0","834","48","882","47","835","468","22","105","122","22","11","20","65","29.10.12"
"630519","179","Харківська область","школа, фойє
вул.50 років України, 1А, с.Шляхове, Кегичівський р-н, Харківська обл., 64024","688","305","679","41","342","41","383","","0","342","41","383","28","355","158","27","48","55","22","8","18","19","28.10.12"
"630530","179","Харківська область","Педагогічний коледж, актова зала
вул.Московська, 47, м.Красноград, Красноградський р-н, Харківська обл., 63301","1576","788","1595","90","734","54","788","","0","734","54","788","26","762","271","15","152","43","12","46","63","160","29.10.12"
"630531","179","Харківська область","Професійний ліцей, спортивна зала
вул.Московська, 45А, м.Красноград, Красноградський р-н, Харківська обл., 63301","1744","895","1699","30","825","24","849","","0","825","24","849","28","821","298","18","175","60","15","52","31","172","29.10.12"
"630532","179","Харківська область","Гімназія ""Гранд"", хол
3 мікрорайон, 32, м.Красноград, Красноградський р-н, Харківська обл., 63304","1800","845","1778","30","933","22","955","","0","933","22","955","51","904","331","21","175","76","11","50","39","201","29.10.12"
"630533","179","Харківська область","школа №2, спортивна зала
вул.Кірова, 57, м.Красноград, Красноградський р-н, Харківська обл., 63304","1544","798","1524","36","722","24","746","","0","722","24","746","61","685","254","13","133","65","12","30","20","158","29.10.12"
"630534","179","Харківська область","Красноградське ДЕП, актова зала
вул.Полтавська, 2, м.Красноград, Красноградський р-н, Харківська обл., 63304","880","422","865","38","424","34","458","","0","424","34","458","15","443","145","6","79","29","4","22","22","136","29.10.12"
"630535","179","Харківська область","Медичний коледж, адміністративний корпус
вул.Лермонтова, 43, м.Красноград, Красноградський р-н, Харківська обл., 63304","744","280","769","39","431","33","464","","0","431","33","464","22","442","161","8","81","27","11","26","19","109","29.10.12"
"630536","179","Харківська область","ККП ""Водоканал"", фойє
вул.Ленінградська, 66, м.Красноград, Красноградський р-н, Харківська обл., 63304","1056","519","1049","20","518","19","537","","0","518","19","537","30","507","134","7","121","32","2","26","57","128","28.10.12"
"630537","179","Харківська область","школа №1, актова зала
вул.Лермонтова, 49, м.Красноград, Красноградський р-н, Харківська обл., 63304","1592","729","1580","58","817","46","863","","0","816","46","862","37","825","293","11","165","50","12","34","46","214","29.10.12"
"630538","179","Харківська область","Будинок культури, методичний кабінет
вул.Леніна, 67, м.Красноград, Красноградський р-н, Харківська обл., 63304","1232","596","1215","31","613","23","636","","0","613","23","636","36","600","208","18","115","33","9","23","28","166","28.10.12"
"630539","179","Харківська область","Багатопрофільний ліцей №4, спортивна зала
вул.19 Вересня, 119А, м.Красноград, Красноградський р-н, Харківська обл., 63304","872","410","858","30","434","28","462","","0","434","28","462","21","441","174","7","87","26","5","19","16","107","29.10.12"
"630540","179","Харківська область","Будинок техніки, фойє
вул.Полтавська, 86, м.Красноград, Красноградський р-н, Харківська обл., 63304","1592","762","1553","32","802","28","830","","0","802","28","830","18","812","287","21","143","52","11","59","31","208","29.10.12"
"630541","179","Харківська область","спортивна школа, спортивна зала
вул.Жовтнева, 76, м.Красноград, Красноградський р-н, Харківська обл., 63304","728","339","738","34","363","26","389","","0","363","26","389","21","368","140","4","66","17","4","20","18","99","28.10.12"
"630542","179","Харківська область","школа №3, спортивна зала
вул.Горького, 114, м.Красноград, Красноградський р-н, Харківська обл., 63304","744","354","733","18","376","14","390","","0","376","14","390","22","368","112","10","54","41","7","19","15","110","29.10.12"
"630543","179","Харківська область","ТОВ ""Красноградський млин"", актова зала
вул.Полтавська, 186, м.Красноград, Красноградський р-н, Харківська обл., 63304","1136","591","1138","48","502","43","545","","0","502","43","545","24","521","191","7","85","32","11","43","34","118","29.10.12"
"630544","179","Харківська область","дитячий садок, фойє
дитячий садок, с-ще Дослідне, Красноградський р-н, Харківська обл., 63308","600","316","608","36","250","34","284","","0","250","34","284","10","274","105","7","42","13","4","9","25","69","28.10.12"
"630545","179","Харківська область","Володимирівська школа, фойє
вул.Верхня, Володимирівська школа, с.Володимирівка, Красноградський р-н, Харківська обл., 63374","576","197","520","53","328","51","379","","0","328","51","379","25","354","176","5","52","42","9","2","15","53","28.10.12"
"630546","179","Харківська область","Лукашівська школа, спортивна зала
пров.Шкільний, Лукашівська школа, с.Лукашівка, Красноградський р-н, Харківська обл., 63372","376","111","374","29","242","23","265","","0","242","23","265","14","251","127","6","39","17","6","2","18","36","28.10.12"
"630547","179","Харківська область","Сільський клуб, фойє
вул.Центральна, 82, с.Кирилівка, Красноградський р-н, Харківська обл., 63320","536","235","515","66","247","54","301","","0","247","54","301","11","290","78","6","39","25","6","73","15","48","28.10.12"
"630548","179","Харківська область","будинок культури, фойє
вул.Шевченка, будинок культури, с.Кобзівка, Красноградський р-н, Харківська обл., 63361","592","225","588","44","326","41","367","","0","326","41","367","19","348","177","3","64","26","9","3","9","57","28.10.12"
"630549","179","Харківська область","сільський клуб, фойє
вул.Радянська, сільський клуб, с-ще Ленінське, Красноградський р-н, Харківська обл., 63345","416","173","403","20","228","15","243","","0","228","15","243","13","230","118","9","34","13","8","4","27","17","29.10.12"
"630550","179","Харківська область","Ленінська школа, спортивна зала
вул.Молодіжна, Ленінська школа, с.Ленінка, Красноградський р-н, Харківська обл., 63350","480","158","466","31","292","30","322","","0","292","30","322","18","304","152","7","32","27","5","2","15","64","29.10.12"
"630551","179","Харківська область","Тишенківська школа, спортивна зала
вул.Центральна, Тишенківська школа, с.Тишенківка, Красноградський р-н, Харківська обл., 63331","288","102","281","34","154","32","186","","0","154","32","186","10","176","85","2","32","11","1","3","3","39","29.10.12"
"630552","179","Харківська область","будинок культури, фойє
вул.Центральна, будинок культури, с.Мартинівка, Красноградський р-н, Харківська обл., 63350","928","454","922","85","402","72","474","","0","402","72","474","25","449","206","10","72","37","4","12","39","69","29.10.12"
"630553","179","Харківська область","будинок культури, глядацька зала
вул.Українська, будинок культури, с.Миколо-Комишувата, Красноградський р-н, Харківська обл., 63310","976","442","954","80","460","74","534","","0","460","74","534","45","489","212","19","83","62","7","16","16","74","29.10.12"
"630554","179","Харківська область","Наталинська школа, спортивна зала
вул.Красноармійська, 34, с.Наталине, Красноградський р-н, Харківська обл., 63343","1848","828","1822","83","940","80","1020","","0","940","80","1020","62","958","386","35","162","108","17","35","36","179","28.10.12"
"630555","179","Харківська область","ГПУ""Шебелінкагазвидобування"", актова зала
вул.Красноармійська, 54, с.Наталине, Красноградський р-н, Харківська обл., 63343","944","478","935","29","439","27","466","","0","439","27","466","38","428","196","12","84","35","3","19","12","67","29.10.12"
"630556","179","Харківська область","Октябрська школа, спортивна зала
вул.Леніна, 252, с.Октябрське, Красноградський р-н, Харківська обл., 63322","712","261","696","80","373","78","451","","0","373","78","451","20","431","210","12","43","41","6","25","12","82","28.10.12"
"630557","179","Харківська область","Берестовеньківська школа, спортивна зала
вул.Радянська, 74, с.Берестовенька, Красноградський р-н, Харківська обл., 63323","808","296","798","92","420","92","512","","0","420","92","512","20","492","206","9","44","47","3","24","21","138","28.10.12"
"630558","179","Харківська область","Петрівська школа, спортивна зала
вул.Шкільна, Петрівська школа, с.Петрівка, Красноградський р-н, Харківська обл., 63340","1344","558","1314","106","683","103","786","","0","683","103","786","34","752","289","47","110","96","12","27","86","85","29.10.12"
"630559","179","Харківська область","Міжшкільний виробничий комбінат, фойє
вул.Леніна, міжшкільний виробничий комбінат, с-ще Балки, Красноградський р-н, Харківська обл., 63341","384","160","375","23","203","21","224","","0","203","21","224","9","215","101","14","35","17","0","7","9","32","29.10.12"
"630560","179","Харківська область","Піщанська школа, головний корпус, спортивна зала
вул.Шевченка, 38А, с.Піщанка, Красноградський р-н, Харківська обл., 63332","1568","805","1473","64","702","61","763","","0","702","61","763","43","720","286","7","92","46","8","25","23","233","29.10.12"
"630561","179","Харківська область","Піщанська школа, корпус початкових класів, приміщення холу
вул.Леніна, 53А, с.Піщанка, Красноградський р-н, Харківська обл., 63332","1696","732","1590","57","915","49","964","","0","915","49","964","55","909","362","17","174","79","13","17","39","208","29.10.12"
"630562","179","Харківська область","Піщанська школа, хол
вул.Полтавська, 257А, с.Піщанка, Красноградський р-н, Харківська обл., 63332","1088","585","1062","58","450","53","503","","0","450","53","503","24","479","211","8","65","35","12","11","17","120","29.10.12"
"630563","179","Харківська область","сільський клуб, хол
вул.Комсомольська, сільський клуб, с-ще Жовтневе, Красноградський р-н, Харківська обл., 63335","200","43","193","18","139","18","157","","0","139","18","157","10","147","111","5","13","8","3","0","1","6","29.10.12"
"630564","179","Харківська область","Попівська школа, їдальня
вул.Кірова, Попівська школа, с.Попівка, Красноградський р-н, Харківська обл., 63344","1088","481","1087","71","547","60","607","","0","547","60","607","32","575","259","21","103","67","9","9","24","83","28.10.12"
"630565","179","Харківська область","Роздольська школа, спортивна зала
вул.Шкільна, Роздольська школа, с.Ясна Поляна, Красноградський р-н, Харківська обл., 63362","240","78","234","24","140","22","162","","0","140","22","162","7","155","70","6","26","11","3","3","25","11","28.10.12"
"630566","179","Харківська область","сільська рада, обрядова зала
сільська рада, с.Соснівка, Красноградський р-н, Харківська обл., 36324","328","111","321","34","189","28","217","","0","189","28","217","14","203","72","5","74","16","6","4","9","17","28.10.12"
"630567","179","Харківська область","Березівська школа, спортивна зала
Березівська школа, с.Березівка, Красноградський р-н, Харківська обл., 63324","352","139","346","39","180","33","213","","0","180","33","213","9","204","57","6","72","22","7","6","9","25","28.10.12"
"630568","179","Харківська область","Хрестищенська школа, фойє
вул.Комсомольська, 29, с.Хрестище, Красноградський р-н, Харківська обл., 63311","704","286","683","26","394","24","418","","0","394","24","418","27","391","135","12","53","42","12","57","22","58","29.10.12"
"630569","179","Харківська область","сільський клуб, зала
вул.Центральна, сільський клуб, с.Українка, Красноградський р-н, Харківська обл., 63312","208","61","212","21","127","20","147","","0","127","20","147","7","140","65","4","15","15","3","5","19","14","29.10.12"
"630570","179","Харківська область","сільський клуб, фойє
вул.Центральна, сільський клуб, с.Першотравневе, Красноградський р-н, Харківська обл., 63311","176","39","179","7","130","7","137","","0","130","7","137","2","135","74","4","9","11","1","21","7","8","29.10.12"
"630571","179","Харківська область","центральна районна лікарня (хірургічний корпус), хол
вул.Ленінградська, 87, м.Красноград, Красноградський р-н, Харківська обл., 63304","112","35","88","31","52","25","77","","0","52","25","77","5","72","33","0","14","3","1","4","5","12","29.10.12"
"630639","179","Харківська область","Краснопавлівський НВК, вестибюль
вул.Маяковського, 61, смт Краснопавлівка, Лозівський р-н, Харківська обл., 64620","1672","940","1658","66","678","54","732","","0","678","54","732","27","705","258","39","57","215","2","6","70","58","29.10.12"
"630640","179","Харківська область","Дитяча музична школа, концертна зала
вул.Суворова, 2, смт Краснопавлівка, Лозівський р-н, Харківська обл., 64620","656","289","677","29","342","25","367","","0","342","25","367","9","358","141","13","39","72","6","2","38","47","29.10.12"
"630641","179","Харківська область","будинок культури ""Дніпро"", танцювальна зала
мікрорайон, будинок культури ""Дніпро"", смт Краснопавлівка, Лозівський р-н, Харківська обл., 64620","1632","807","1648","31","797","28","825","","0","797","28","825","28","797","287","18","65","248","9","10","78","82","29.10.12"
"630642","179","Харківська область","Краснопавлівський багатопрофільний ліцей, спортивна зала
мікрорайон, Краснопавлівський багатопрофільний ліцей, смт Краснопавлівка, Лозівський р-н, Харківська обл., 64620","1936","898","1910","50","991","47","1038","","0","991","47","1038","44","994","462","33","84","176","6","11","85","137","29.10.12"
"630643","179","Харківська область","Орільська селищна рада, зала засідань
вул.Жовтнева, 58, смт Орілька, Лозівський р-н, Харківська обл., 64640","1336","724","1314","79","540","72","612","","0","540","72","612","18","594","242","16","50","54","27","9","138","58","28.10.12"
"630644","179","Харківська область","Орільський аграрно-технічний ліцей, їдальня
вул.Заводська, 2, смт Орілька, Лозівський р-н, Харківська обл., 64640","1736","898","1693","57","786","52","838","","0","786","52","838","28","810","310","33","50","50","22","25","185","135","29.10.12"
"630645","179","Харківська область","Петропільський НВК, спортивна зала
вул.Горького, 13А, с.Петропілля, Лозівський р-н, Харківська обл., 64643","296","122","290","14","162","12","174","","0","162","12","174","2","172","123","3","5","8","1","0","26","6","29.10.12"
"630646","179","Харківська область","Петрівський НВК, їдальня
вул.Молодіжна, 15А, с.Петрівське, Лозівський р-н, Харківська обл., 64645","400","171","378","46","186","43","229","","0","186","43","229","8","221","86","15","21","16","2","1","71","9","28.10.12"
"630647","179","Харківська область","Артільський НВК, спортивна зала
вул.Леніна, 25, с.Артільне, Лозівський р-н, Харківська обл., 64630","512","150","498","49","318","44","362","","0","318","44","362","11","351","157","5","11","24","6","4","120","24","29.10.12"
"630648","179","Харківська область","Бунаківський НВК, вестибюль
вул.Шевченка, 1А, с.Бунакове, Лозівський р-н, Харківська обл., 64610","464","142","446","54","271","51","322","","0","271","51","322","13","309","98","3","12","104","2","2","66","22","28.10.12"
"630649","179","Харківська область","Єлизаветівський НВК, вестибюль
майдан Т.Г.Шевченка, Єлизаветівський НВК, с.Єлизаветівка, Лозівський р-н, Харківська обл., 64623","752","343","737","38","373","36","409","","0","373","36","409","16","393","195","10","18","90","2","2","8","68","28.10.12"
"630650","179","Харківська область","Катеринівська школа, вестибюль
вул.Шкільна, 16, с.Катеринівка, Лозівський р-н, Харківська обл., 64662","1752","727","1740","139","893","132","1025","","0","893","132","1025","32","993","457","38","100","202","9","13","78","96","29.10.12"
"630651","179","Харківська область","Михайлівський сільський клуб, глядацька зала
вул.Щорса, 1, с.Михайлівка, Лозівський р-н, Харківська обл., 64662","320","152","310","23","145","23","168","","0","145","23","168","2","166","82","8","10","20","5","0","35","6","29.10.12"
"630652","179","Харківська область","Кінненська школа, спортивна зала
вул.Піонерська, 24, с-ще Кінне, Лозівський р-н, Харківська обл., 64681","560","235","535","21","308","17","325","","0","308","17","325","8","317","86","15","17","60","11","6","58","64","29.10.12"
"630653","179","Харківська область","Комсомольський НВК, вестибюль
вул.Шкільна, 1А, с-ще Комсомольське, Лозівський р-н, Харківська обл., 64644","960","439","969","49","479","42","521","","0","478","42","520","25","495","208","18","36","88","4","3","76","62","29.10.12"
"630654","179","Харківська область","Миколаївський будинок культури, глядацька зала
вул.Никитенка, 14, с.Миколаївка, Лозівський р-н, Харківська обл., 64672","544","233","536","28","284","27","311","","0","284","27","311","11","300","159","13","22","19","10","3","50","24","29.10.12"
"630655","179","Харківська область","Надеждівський НВК, вестибюль
вул.Перемоги, 4, с.Надеждівка, Лозівський р-н, Харківська обл., 64680","583","195","570","44","347","41","388","","0","347","41","388","7","381","38","1","6","318","0","1","9","8","29.10.12"
"630656","179","Харківська область","Новоіванівська школа, спортивна зала
вул.Яремчука, 1, с.Нова Іванівка, Лозівський р-н, Харківська обл., 64670","984","381","983","107","502","101","603","","0","502","101","603","17","586","351","24","34","52","8","10","71","36","28.10.12"
"630657","179","Харківська область","Павлівська школа, спортивна зала
вул.Десняка, 7, с.Павлівка Друга, Лозівський р-н, Харківська обл., 64611","320","86","317","21","214","20","234","","0","214","20","234","2","232","38","4","4","163","0","1","19","3","28.10.12"
"630658","179","Харківська область","Перемогівська школа, їдальня
вул.Жовтнева, 6, с.Перемога, Лозівський р-н, Харківська обл., 64633","672","285","663","44","346","41","387","","0","346","41","387","19","368","172","21","34","51","1","2","64","23","29.10.12"
"630659","179","Харківська область","Відділення поштового зв’язку, вестибюль
вул.Заводська, 2, с.Герсеванівка, Лозівський р-н, Харківська обл., 64634","344","134","334","26","184","26","210","","0","184","26","210","8","202","109","9","12","34","2","2","16","18","29.10.12"
"630660","179","Харківська область","Плисівський сільський клуб, глядацька зала
вул.Центральна, 22, с.Плисове, Лозівський р-н, Харківська обл., 64624","384","144","368","27","213","27","240","","0","213","27","240","6","234","152","3","13","35","3","3","20","5","28.10.12"
"630661","179","Харківська область","Садівська школа, вестибюль
вул.Леніна, 81, с.Садове, Лозівський р-н, Харківська обл., 64683","608","177","590","77","356","75","431","","0","356","75","431","11","420","184","6","15","181","4","0","13","17","29.10.12"
"630662","179","Харківська область","Смирнівський НВК, спортивна зала
вул.Миру, 5, с.Смирнівка, Лозівський р-н, Харківська обл., 64650","1024","391","1007","57","576","57","633","","0","576","57","633","18","615","300","15","38","120","7","7","44","84","28.10.12"
"630663","179","Харківська область","Контора ПОСП ""Прогрес"", зала засідань
вул.Полтавська, 39, с.Тихопілля, Лозівський р-н, Харківська обл., 64682","360","105","359","19","240","15","255","","0","240","15","255","6","249","137","10","11","48","1","0","25","17","28.10.12"
"630664","179","Харківська область","Царедарівський НВК, актова зала
вул.Котовського, 13, с.Царедарівка, Лозівський р-н, Харківська обл., 64661","720","293","702","43","386","41","427","","0","386","41","427","12","415","204","25","56","38","8","3","43","38","29.10.12"
"630665","179","Харківська область","Полтавський сільський клуб, глядацька зала
вул.Шкільна, 1, с.Полтавське, Лозівський р-н, Харківська обл., 64661","440","130","433","40","272","38","310","","0","272","38","310","12","298","93","2","21","108","2","4","53","15","28.10.12"
"630666","179","Харківська область","Чернігівська сільська рада, зала засідань
вул.Садова, 15, с-ще Чернігівське, Лозівський р-н, Харківська обл., 64632","688","208","670","101","381","99","480","","0","381","99","480","2","478","316","3","19","56","1","1","51","31","29.10.12"
"630667","179","Харківська область","Шатівський НВК, вестибюль
вул.Молодіжна, 2, с.Олександрівка, Лозівський р-н, Харківська обл., 64651","736","260","723","64","416","60","476","","0","416","60","476","19","457","261","17","26","77","3","4","49","20","29.10.12"
"630668","179","Харківська область","Яковлівський НВК, спортивна зала
вул.Леніна, 2, с.Яковлівка, Лозівський р-н, Харківська обл., 64625","1136","513","1124","107","522","101","623","","0","522","101","623","23","600","391","7","28","59","2","6","62","45","29.10.12"
"630669","179","Харківська область","Фізіотерапевтичне відділення, вестибюль
вул.Леніна, 42, с.Катеринівка, Лозівський р-н, Харківська обл., 64662","256","187","78","23","47","22","69","","0","47","22","69","2","67","30","5","4","5","0","1","16","6","29.10.12"
"630745","179","Харківська область","школа, актовий зал
вул.Шкільна, 27, с.Аполлонівка, Сахновщинський р-н, Харківська обл., 64541","368","165","355","16","187","16","203","","0","187","16","203","10","193","77","4","26","35","13","5","21","12","28.10.12"
"630746","179","Харківська область","школа, актовий зал
пров.Шкільний, 1, с.Багата Чернещина, Сахновщинський р-н, Харківська обл., 64560","472","219","463","20","235","18","253","","0","235","18","253","8","245","132","19","33","14","7","5","23","12","29.10.12"
"630747","179","Харківська область","школа, актовий зал
вул.Перемоги, 19, с.Великі Бучки, Сахновщинський р-н, Харківська обл., 64562","352","152","343","17","183","17","200","","0","183","17","200","9","191","59","1","23","63","4","2","33","6","29.10.12"
"630748","179","Харківська область","сільська рада, кімната засідань
вул.Миру, 34, с.Володимирівка, Сахновщинський р-н, Харківська обл., 64540","192","81","183","9","103","8","111","","0","103","8","111","1","110","28","6","17","30","1","5","19","4","29.10.12"
"630749","179","Харківська область","сільська бібліотека, читальний зал
вул.Шкільна, 21, с.Орільське, Сахновщинський р-н, Харківська обл., 64540","152","50","154","20","82","20","102","","0","82","20","102","6","96","13","2","26","17","1","2","29","6","29.10.12"
"630750","179","Харківська область","школа, актовий зал
вул.Шкільна, 15, с.Гришівка, Сахновщинський р-н, Харківська обл., 64522","512","233","506","3","276","3","279","","0","276","3","279","10","269","106","14","47","50","4","7","20","21","28.10.12"
"630751","179","Харківська область","сільський будинок культури, актовий зал
вул.Центральна, 24, с.Дар-Надежда, Сахновщинський р-н, Харківська обл., 64520","168","64","170","1","103","1","104","","0","103","1","104","12","92","36","4","6","20","1","2","4","19","28.10.12"
"630752","179","Харківська область","сільський будинок культури, зал
вул.Центральна, 16, с.Максимівка, Сахновщинський р-н, Харківська обл., 64521","152","50","147","13","91","11","102","","0","91","11","102","3","99","28","3","6","35","3","1","17","6","28.10.12"
"630753","179","Харківська область","школа, актовий зал
вул.Першотравнева, 12, с.Дубові Гряди, Сахновщинський р-н, Харківська обл., 64563","504","178","499","39","293","33","326","","0","293","33","326","13","313","172","6","60","27","3","7","19","19","29.10.12"
"630754","179","Харківська область","сільська рада, кімната засідань
вул.Кооперативна, 1, с.Катеринівка, Сахновщинський р-н, Харківська обл., 64552","792","341","781","41","416","35","451","","0","416","35","451","18","433","211","20","74","39","9","20","26","34","28.10.12"
"630755","179","Харківська область","сільський будинок культури, зал
вул.Центральна, 7, с.Красноярка, Сахновщинський р-н, Харківська обл., 64514","240","89","236","17","134","17","151","","0","134","17","151","8","143","49","12","15","41","9","3","8","6","29.10.12"
"630756","179","Харківська область","навчально-виховний комплекс, актовий зал
вул.Леніна, 3, с.Лебедівка, Сахновщинський р-н, Харківська обл., 64512","520","195","514","13","313","12","325","","0","313","12","325","6","319","87","23","88","54","7","6","27","27","28.10.12"
"630757","179","Харківська область","школа, актовий зал
вул.Центральна, 19, с.Бондарівка, Сахновщинський р-н, Харківська обл., 64515","216","79","212","11","126","11","137","","0","126","11","137","7","130","47","2","12","19","5","2","36","7","28.10.12"
"630758","179","Харківська область","навчально-виховний комплекс, актовий зал
вул.Шкільна, 2, с.Лигівка, Сахновщинський р-н, Харківська обл., 64514","832","447","819","29","356","29","385","","0","356","29","385","17","368","138","20","68","63","8","11","33","27","29.10.12"
"630759","179","Харківська область","школа, їдальня
вул.Чкалова, 26, с.Новоолександрівка, Сахновщинський р-н, Харківська обл., 64550","600","300","592","34","266","34","300","","0","266","34","300","12","288","111","7","46","64","2","3","42","13","28.10.12"
"630760","179","Харківська область","школа, актовий зал
вул.1 Травня, 4А, с.Новодмитрівка, Сахновщинський р-н, Харківська обл., 64551","384","203","376","32","152","29","181","","0","152","29","181","7","174","44","6","31","34","8","5","14","32","29.10.12"
"630761","179","Харківська область","бібліотека, читальний зал
вул.Перемоги, 25, с.Надеждине, Сахновщинський р-н, Харківська обл., 64514","192","79","194","19","95","18","113","","0","95","18","113","4","109","63","1","11","19","1","3","5","6","29.10.12"
"630762","179","Харківська область","сільська рада, фойє
вул.Дружби, 85, с.Нова Чернещина, Сахновщинський р-н, Харківська обл., 64530","376","144","377","22","210","22","232","","0","210","22","232","13","219","87","7","30","29","3","7","39","17","28.10.12"
"630763","179","Харківська область","сільський будинок культури, зал
вул.Центральна, 33, с.Костянтинівка, Сахновщинський р-н, Харківська обл., 64531","272","99","266","13","160","13","173","","0","160","13","173","7","166","63","4","11","40","6","3","32","7","29.10.12"
"630764","179","Харківська область","сільська рада, кімната засідань
вул.Пожидаєва, 2, с.Огіївка, Сахновщинський р-н, Харківська обл., 64532","720","300","710","78","343","77","420","","0","343","77","420","11","409","230","7","83","31","3","2","27","26","29.10.12"
"630765","179","Харківська область","школа, актовий зал
пров.Шкільний, 2, с.Олійники, Сахновщинський р-н, Харківська обл., 64510","456","164","465","38","263","29","292","","0","263","29","292","17","275","122","8","53","43","9","10","10","20","29.10.12"
"630766","179","Харківська область","амбулаторія, кабінет прийому громадян
вул.Мирного, 37, с.Мар’ївка, Сахновщинський р-н, Харківська обл., 64510","232","77","230","14","142","13","155","","0","142","13","155","5","150","45","9","23","16","8","21","13","15","29.10.12"
"630767","179","Харківська область","школа, актовий зал
вул.Шкільна, 10, с.Новомихайлівка, Сахновщинський р-н, Харківська обл., 64511","112","32","111","8","72","8","80","","0","72","8","80","4","76","28","2","6","21","1","1","12","5","29.10.12"
"630768","179","Харківська область","школа, актовий зал
вул.Шуліки, 48/2, с.Тавежня, Сахновщинський р-н, Харківська обл., 64561","216","78","211","13","125","13","138","","0","125","13","138","5","133","52","5","24","14","8","5","16","9","28.10.12"
"630769","179","Харківська область","дитячий садок, великий зал
вул.Шевченка, 34/2, с.Шевченкове, Тавежнянська сільська рада, Сахновщинський р-н, Харківська обл., 64561","200","82","192","22","97","21","118","","0","97","21","118","2","116","72","5","18","10","1","0","7","3","29.10.12"
"630770","179","Харківська область","школа, актовий зал
вул.Шкільна, 14, с.Шевченкове, Шевченківська сільська рада, Сахновщинський р-н, Харківська обл., 64513","648","316","636","17","322","10","332","","0","322","10","332","26","306","88","12","101","25","19","9","31","21","28.10.12"
"630771","179","Харківська область","ПСП ""Маяк"", зал для відпочинку
вул.Комарова, 68, смт Сахновщина, Сахновщинський р-н, Харківська обл., 64501","544","310","531","14","220","14","234","","0","220","14","234","14","220","74","11","38","51","8","5","19","14","29.10.12"
"630772","179","Харківська область","школа, фойє
школа, с.Чорнолозка, Сахновщинський р-н, Харківська обл., 64509","176","76","187","16","84","16","100","","0","84","16","100","9","91","41","6","4","13","1","2","19","5","29.10.12"
"630773","179","Харківська область","ВАТ ""20-річчя Жовтня"", фойє
ВАТ ""20-річчя Жовтня"", с.Жовтень, Сахновщинський р-н, Харківська обл., 64508","456","161","459","26","274","21","295","","0","274","21","295","12","283","151","9","32","14","5","10","12","50","28.10.12"
"630774","179","Харківська область","гімназія, актовий зал
вул.Червоноармійська, 14, смт Сахновщина, Сахновщинський р-н, Харківська обл., 64501","1472","754","1425","14","705","13","718","","0","705","13","718","33","685","278","28","128","72","7","20","35","117","29.10.12"
"630775","179","Харківська область","районний будинок культури, фойє
вул.Народна, 2, смт Сахновщина, Сахновщинський р-н, Харківська обл., 64501","1464","761","1407","10","695","8","703","","0","695","8","703","43","660","243","13","147","77","7","27","42","104","29.10.12"
"630776","179","Харківська область","школа №2, фойє
вул.Остапченко, 56, смт Сахновщина, Сахновщинський р-н, Харківська обл., 64501","1560","888","1537","19","658","14","672","","0","658","14","672","44","628","276","17","139","57","13","11","30","85","29.10.12"
"630777","179","Харківська область","ДП Сахновщинський елеватор, кімната відпочинку
вул.17 Вересня, 70, смт Сахновщина, Сахновщинський р-н, Харківська обл., 64501","1136","648","1123","11","481","7","488","","0","481","7","488","32","456","167","19","100","64","7","14","38","47","29.10.12"
"630778","179","Харківська область","ВАТ ""Сахновщинське РТП"", кімната відпочинку
вул.Пархоменко, 26, смт Сахновщина, Сахновщинський р-н, Харківська обл., 64501","448","219","455","10","219","10","229","","0","219","10","229","10","219","74","11","51","25","3","2","28","25","28.10.12"
"630999","179","Харківська область","дитяча музична школа, актова зала
вул.Жовтнева, 10, м.Лозова, Харківська обл., 64602","1528","603","1497","38","891","34","925","","0","891","34","925","18","907","376","63","142","121","5","10","89","101","29.10.12"
"631000","179","Харківська область","училище культури і мистецтв, фойє
вул.Урицького, 2, м.Лозова, Харківська обл., 64602","1384","597","1352","74","729","58","787","","0","729","58","787","19","768","311","37","101","109","10","16","69","115","28.10.12"
"631001","179","Харківська область","відділення НАСК ""Оранта"", к.6
вул.Некрасова, 21, м.Лозова, Харківська обл., 64602","1216","551","1198","43","630","35","665","","0","630","35","665","16","649","263","29","93","102","7","17","55","83","29.10.12"
"631002","179","Харківська область","автошкола, вестибюль
вул.Рози Люксембург, 74А, м.Лозова, Харківська обл., 64602","840","405","821","39","399","36","435","","0","399","36","435","10","425","203","20","45","76","6","2","35","38","28.10.12"
"631003","179","Харківська область","Лозівський професійний ліцей, вестибюль
вул.Свободи, 4А, м.Лозова, Харківська обл., 64602","856","426","859","17","413","17","430","","0","413","17","430","14","416","209","16","45","54","4","6","44","38","28.10.12"
"631004","179","Харківська область","школа №1, спортзал
мікрорайон 5, 3, м.Лозова, Харківська обл., 64606","2048","881","2011","22","1148","19","1167","","0","1148","19","1167","39","1128","625","49","145","84","23","15","83","104","29.10.12"
"631005","179","Харківська область","школа №1, їдальня
мікрорайон 5, 3, м.Лозова, Харківська обл., 64606","1784","776","1758","18","990","18","1008","","0","990","18","1008","25","983","523","52","151","95","13","11","76","62","28.10.12"
"631006","179","Харківська область","школа №7, їдальня
мікрорайон 3, 29, м.Лозова, Харківська обл., 64606","1792","902","1757","22","876","14","890","","0","876","14","890","27","863","456","57","108","94","8","5","64","71","29.10.12"
"631007","179","Харківська область","школа №7, лівий коридор
мікрорайон 3, 29, м.Лозова, Харківська обл., 64606","1848","899","1835","11","941","8","949","","0","941","8","949","36","913","506","58","131","74","12","13","65","54","29.10.12"
"631008","179","Харківська область","школа №7, правий коридор
мікрорайон 3, 29, м.Лозова, Харківська обл., 64606","1752","749","1722","22","984","19","1003","","0","984","19","1003","24","979","518","63","116","133","13","8","47","81","29.10.12"
"631009","179","Харківська область","школа №3, їдальня
мікрорайон 2, 8, м.Лозова, Харківська обл., 64606","2128","1047","2098","33","1054","27","1081","","0","1054","27","1081","42","1039","555","54","124","104","9","12","86","95","29.10.12"
"631010","179","Харківська область","школа №3, вестибюль
мікрорайон 2, 8, м.Лозова, Харківська обл., 64606","1912","878","1882","35","1005","29","1034","","0","1005","29","1034","37","997","529","66","124","77","17","11","74","99","29.10.12"
"631011","179","Харківська область","КП ""ЖУК"", актова зала
мікрорайон 1, 17, м.Лозова, Харківська обл., 64604","1659","788","1612","51","825","46","871","","0","825","46","871","26","845","448","46","88","70","19","13","40","121","29.10.12"
"631012","179","Харківська область","школа №12, актова зала
мікрорайон 1, 30, м.Лозова, Харківської обл., 64604","1568","750","1548","28","797","21","818","","0","797","21","818","29","789","393","39","82","64","10","6","66","129","29.10.12"
"631013","179","Харківська область","Лозівський колегіум №2, вестибюль
мікрорайон 4, 3, м.Лозова, Харківська обл., 64604","2000","938","1959","36","1033","29","1062","","0","1033","29","1062","27","1035","526","63","136","113","11","9","95","82","29.10.12"
"631014","179","Харківська область","Лозівський колегіум №2, фойє
мікрорайон 4, 3, м.Лозова, Харківська обл., 64604","1696","859","1646","17","826","11","837","","0","826","11","837","12","825","449","47","117","82","7","5","52","66","29.10.12"
"631015","179","Харківська область","Лозівський ліцей №4, приміщення рекреації
мікрорайон 4, 45, м.Лозова, Харківська обл., 64604","2048","962","1999","23","1068","18","1086","","0","1068","18","1086","33","1053","534","57","155","85","7","7","116","92","29.10.12"
"631016","179","Харківська область","Лозівський ліцей №4, приміщення рекреації закладу
мікрорайон 4, 45, м.Лозова, Харківська обл., 64604","1768","755","1723","12","1003","10","1013","","0","1003","10","1013","33","980","480","49","135","100","13","11","86","106","29.10.12"
"631017","179","Харківська область","міський Палац культури, фойє
просп.Перемоги, 1, м.Лозова, Харківська обл., 64604","1784","875","1748","13","901","8","909","","0","901","8","909","19","890","454","51","130","93","11","9","69","73","29.10.12"
"631018","179","Харківська область","технікум, вестибюль
мікрорайон 9, 7, м.Лозова, Харківська обл., 64604","2296","1159","2234","9","1129","8","1137","","0","1129","8","1137","43","1094","656","55","120","85","5","21","71","81","29.10.12"
"631019","179","Харківська область","технікум, вестибюль
мікрорайон 9, 7, м.Лозова, Харківська обл., 64604","864","435","846","61","386","43","429","","0","386","43","429","13","416","213","16","44","37","3","8","42","53","28.10.12"
"631020","179","Харківська область","ДЮСШ ""Юність"", вестибюль
пл.Леніна, 1, м.Лозова, Харківська обл., 64602","1400","643","1382","11","747","10","757","","0","747","10","757","19","738","308","47","118","100","5","7","60","93","28.10.12"
"631021","179","Харківська область","стадіон ""Локомотив"", спортзал
вул.Жовтнева, 64, м.Лозова, Харківська обл., 64602","1136","519","1125","33","584","33","617","","0","584","33","617","23","594","339","26","50","70","7","5","46","51","29.10.12"
"631022","179","Харківська область","школа №10, вестибюль
вул.Жовтнева, 15, м.Лозова, Харківська обл., 64602","1080","522","1062","53","508","50","558","","0","508","50","558","22","536","237","35","72","66","5","10","40","71","29.10.12"
"631023","179","Харківська область","адмінспоруда, хол
вул.Профінтерну, 5, м.Лозова, Харківська обл., 64602","1216","613","1169","28","577","26","603","","0","577","26","603","28","575","260","32","60","66","13","8","56","80","29.10.12"
"631024","179","Харківська область","школа №11, приміщення рекреації
вул.Абросимова, 65А, м.Лозова, Харківська обл., 64602","1128","493","1113","55","584","51","635","","0","584","51","635","18","617","315","27","78","73","9","13","47","55","29.10.12"
"631025","179","Харківська область","ВАТ ""Лозівське"", червоний куточок
вул.Танкістів, 2, м.Лозова, Харківська обл., 64605","1272","602","1278","73","608","62","670","","0","608","62","670","27","643","303","37","74","98","4","10","41","76","29.10.12"
"631026","179","Харківська область","школа №8, приміщення рекреації
вул.Червонопартизанська, 43А, м.Лозова, Харківська обл., 64605","1272","607","1267","80","599","66","665","","0","599","66","665","13","652","293","36","71","62","3","2","86","99","28.10.12"
"631027","179","Харківська область","школа №8, їдальня
вул.Червонопартизанська, 43А, м.Лозова, Харківська обл., 64605","1016","487","1009","66","477","52","529","","0","477","52","529","27","502","256","31","67","52","4","10","38","44","29.10.12"
"631028","179","Харківська область","дистанція електропостачання, клас техбезпеки
вул.Потьомкіна, 7, м.Лозова, Харківська обл., 64605","968","513","956","42","415","40","455","","0","415","40","455","17","438","188","22","45","89","6","7","41","40","28.10.12"
"631029","179","Харківська область","Лозівська дистанція колії, вестибюль
вул.38 Гвардійської дивізії, 1, м.Лозова, Харківська обл., 64605","872","439","865","51","383","50","433","","0","383","50","433","9","424","204","11","37","54","2","7","45","64","29.10.12"
"631030","179","Харківська область","Панютинська школа №2, к.7
вул.Петровського, 32, с.Хлібне, м.Лозова, Харківська обл., 64660","504","205","509","41","264","35","299","","0","264","35","299","10","289","164","8","15","41","5","3","19","34","29.10.12"
"631031","179","Харківська область","БК ДП ""Укрспецвагон"", фойє
вул.Леніна, 2, смт Панютине, м.Лозова, Харківська обл., 64660","1456","631","1444","83","746","79","825","","0","746","79","825","32","793","340","40","82","108","6","9","69","139","29.10.12"
"631032","179","Харківська область","Панютинська школа №1, фойє
вул.Миру, 33, смт Панютине, м.Лозова, Харківська обл., 64660","1464","578","1427","65","834","52","886","","0","834","52","886","43","843","314","33","82","122","9","15","62","206","28.10.12"
"631033","179","Харківська область","Панютинська селищна рада, фойє
вул.Леніна, 11, смт Панютине, м.Лозова, Харківська обл., 64660","1248","512","1230","24","716","20","736","","0","716","20","736","28","708","311","35","71","89","10","9","80","103","29.10.12"
"631034","179","Харківська область","спортзал ДП ""Укрспецвагон""
вул.Леніна, 4, смт Панютине, м.Лозова, Харківська обл., 64660","1256","615","1242","171","533","108","641","","0","533","108","641","47","594","287","24","52","39","9","11","79","93","29.10.12"
"631035","179","Харківська область","Домаський НВК, актова зала
вул.Чапаєва, 11, с.Домаха, м.Лозова, Харківська обл., 64603","1200","530","1189","73","598","72","670","","0","598","72","670","14","656","401","15","58","70","7","5","60","40","28.10.12"
"631036","179","Харківська область","вузлова лікарня ст.Лозова, фойє
вул.Жовтнева, 1, м.Лозова, Харківська обл., 64602","40","4","36","3","33","3","36","","0","33","3","36","1","35","19","4","4","3","0","1","1","3","28.10.12"
"631037","179","Харківська область","Лозівська міська лікарня, фойє
вул.Червоних Артилеристів, 29, м.Лозова, Харківська обл., 64604","208","141","73","21","49","18","67","","0","49","18","67","1","66","30","4","14","4","1","1","5","7","28.10.12"
