"№ ВД","OBO","Назва регіону України","Місцезнаходження та адреса приміщення для голосування","1) К-сть одержаних бюлетенів","2) К-сть невикористаних бюлетенів","3) К-сть виборців, внесених до списку виборців","4) К-сть виборців, внесених до витягу зі списку виборців","5) К-сть виборців, які отримали бюлетені у приміщенні","6) К-сть виборців, які отримали за місцем перебування","7) Сумарна к-сть виборців, які отримали бюлетені","8) К-сть бюлетенів, що виявилися у кожній скринці","9) К-сть бюлетенів, що не підлягають врахуванню","10) К-сть виборців, які взяли участь у голос. у приміщенні для гол.","11) К-сть виборців, які взяли участь у голос. за місцем перебування","12) К-сть виборців, які взяли участь у голосуванні на виборчій дільниці","13) К-сть бюлетенів, визнаних недійсними","14) Сумарна к-сть голосів виборців ЗА","Анчишкін
Артур
Леонідович","Артьоменко
Вікторія
Вячеславівна","Берестецька
Віолета
Едуардівна","Василенко
Богдан
Юрійович","Дяченко
Олександр
Васильович","Кальцев
Сергій
Федорович","Максимов
Володимир
Степанович","Петрашин
Леонід
Григорович","Рекалов
Геннадій
Олександрович","Савчин
Богдан
Васильович","Старух
Олександр
Васильович","Федченко
Віктор
Іванович","Холодков
Микола
Петрович","Хотлубей
Василь
Григорович","Швець
Володимир
Станіславович","Шевченко
Євгеній
Володимирович","Шуманов
Дмитро
Леонідович","Дата підписання протоколу"
"230837","75","Запорізька область","навчально-виховний комплекс №67, фойє
вул.Сеченова, 25, м.Запоріжжя, 69067","2456","1129","2418","35","1300","27","1327","","0","1298","27","1325","59","1266","7","16","15","140","80","599","5","5","57","22","159","6","94","14","6","23","18","29.10.12"
"230838","75","Запорізька область","КП ""Виробниче ремонтно-експлуатаційне житлове об’єднання №4"", актова зала
вул.Сеченова, 48/64, м.Запоріжжя, 69067","2480","1139","2455","25","1321","20","1341","","0","1321","20","1341","50","1291","9","23","18","127","102","604","4","2","48","14","184","4","106","11","6","12","17","29.10.12"
"230839","75","Запорізька область","школа №54, рекреація
вул.Соснова, 24, м.Запоріжжя, 69067","2308","1110","2301","17","1184","14","1198","","0","1184","14","1198","34","1164","8","18","16","139","85","499","8","4","53","9","176","5","99","8","17","12","8","29.10.12"
"230840","75","Запорізька область","школа №33, фойє
вул.Ніжинська, 40, м.Запоріжжя, 69067","2368","1001","2341","41","1340","27","1367","","0","1340","27","1367","42","1325","17","22","11","140","125","507","5","2","81","8","239","3","113","9","19","11","13","29.10.12"
"230841","75","Запорізька область","гуртожиток, актова зала
вул.Історична, 37, м.Запоріжжя, 69106","2476","1234","2441","18","1226","16","1242","","0","1226","16","1242","55","1187","19","26","8","149","74","574","11","2","52","21","105","6","101","13","5","12","9","29.10.12"
"230842","75","Запорізька область","школа №67, фойє
вул.Радіаторна, 26, м.Запоріжжя, 69067","2016","961","1999","22","1037","18","1055","","0","1037","18","1055","35","1020","8","23","9","146","52","458","8","4","38","15","140","4","72","6","7","23","7","29.10.12"
"230843","75","Запорізька область","школа №67, фойє
вул.Радіаторна, 26, м.Запоріжжя, 69067","1756","733","1748","27","999","24","1023","","0","999","24","1023","35","988","6","14","12","98","60","481","6","8","41","25","126","5","78","12","5","7","4","29.10.12"
"230844","75","Запорізька область","палац культури, фойє
вул.Лізи Чайкіної, 53, м.Запоріжжя, 69067","2196","915","2180","35","1253","28","1281","","1","1253","28","1281","47","1234","13","17","5","166","79","542","7","6","69","5","197","3","74","16","7","21","7","29.10.12"
"230845","75","Запорізька область","палац культури, вестибюль
вул.Лізи Чайкіної, 53, м.Запоріжжя, 69067","2228","985","2207","33","1214","29","1243","","0","1213","29","1242","51","1191","15","32","13","154","84","529","11","5","43","15","142","3","98","12","3","20","12","03.11.12"
"230846","75","Запорізька область","центр-інтернат ""Оберіг"", фойє
вул.Олександра Невського, 87А, м.Запоріжжя, 69067","2164","932","2127","36","1201","31","1232","","0","1201","31","1232","26","1206","12","15","13","148","97","603","4","2","64","10","128","5","67","15","7","11","5","29.10.12"
"230847","75","Запорізька область","школа №13, фойє
вул.Селищна, 50, м.Запоріжжя, 69046","1020","380","1020","25","617","23","640","","0","617","23","640","22","618","6","3","6","37","25","354","3","1","26","1","76","2","45","12","10","7","4","29.10.12"
"230848","75","Запорізька область","амбулаторія комунальної установи ""Центральна клінічна лікарня №4"", фойє
вул.Скворцова, 126, м.Запоріжжя, 69106","608","220","609","18","370","18","388","","0","370","18","388","18","370","4","6","3","21","41","193","3","0","6","3","47","1","24","10","4","3","1","28.10.12"
"230849","75","Запорізька область","будинок творчості, фойє
пров.Черепашковий, 1, м.Запоріжжя, 69009","2440","1116","2397","45","1285","39","1324","","0","1285","39","1324","40","1284","9","19","15","152","56","627","16","3","59","22","147","9","96","15","5","24","10","28.10.12"
"230850","75","Запорізька область","школа №75, фойє
вул.Історична, 92, м.Запоріжжя, 69009","2444","1280","2397","21","1148","16","1164","","0","1148","16","1164","49","1115","12","31","12","117","56","546","7","4","35","22","133","8","89","9","5","20","9","29.10.12"
"230851","75","Запорізька область","""Запорізьке вище індустріальне політехнічне училище"", актова зала
вул.Перспективна, 2Б, м.Запоріжжя, 69009","2396","1162","2362","46","1198","36","1234","","0","1198","36","1234","24","1210","14","17","9","149","44","559","11","1","79","16","151","4","106","15","5","22","8","29.10.12"
"230852","75","Запорізька область","гімназія №46, спотрзал
вул.Орджонікідзе, 29, м.Запоріжжя, 69009","2320","1122","2283","11","1190","8","1198","","0","1190","8","1198","34","1164","16","25","12","130","48","595","7","1","43","11","118","8","107","9","5","20","9","29.10.12"
"230853","75","Запорізька область","палац культури, фойє
вул.Орджонікідзе, 22, м.Запоріжжя, 69106","2408","1140","2389","14","1256","12","1268","","0","1256","12","1268","47","1221","14","23","14","126","40","603","9","2","66","17","145","9","93","17","8","24","11","29.10.12"
"230854","75","Запорізька область","гімназія №46, актова зала
вул.Орджонікідзе, 29, м.Запоріжжя, 69009","2060","961","2030","35","1076","23","1099","","0","1076","23","1099","35","1064","16","16","12","144","53","495","11","5","48","14","101","1","93","10","6","28","11","29.10.12"
"230855","75","Запорізька область","гімназія №47, спортивна зала
вул.Орджонікідзе, 9, м.Запоріжжя, 69106","2116","935","2094","10","1173","8","1181","","0","1173","8","1181","40","1141","11","11","10","157","67","511","9","5","48","20","146","9","93","10","2","23","9","29.10.12"
"230856","75","Запорізька область","гімназія №47, вестибюль
вул.Орджонікідзе, 9, м.Запоріжжя, 69106","1704","817","1701","25","872","15","887","","0","872","15","887","27","860","13","22","10","105","73","362","7","0","36","87","13","6","84","14","6","18","4","29.10.12"
"230857","75","Запорізька область","школа №36, рекреація
вул.Билкіна, 12, м.Запоріжжя, 69034","1920","917","1910","34","971","32","1003","","0","971","32","1003","31","972","6","31","15","110","28","416","5","1","66","13","148","8","76","16","8","16","9","29.10.12"
"230858","75","Запорізька область","школа №21, спортивна зала
вул.Машинна, 117, м.Запоріжжя, 69021","2176","1039","2165","18","1123","14","1137","","0","1123","14","1137","47","1090","14","31","11","92","45","509","8","4","81","36","147","1","67","17","9","13","5","29.10.12"
"230859","75","Запорізька область","школа №85, фойє
пров.Економічний, 5, м.Запоріжжя, 69021","2140","1046","2131","30","1072","22","1094","","0","1072","22","1094","45","1049","15","32","12","122","57","388","9","2","107","18","126","11","102","17","13","11","7","29.10.12"
"230860","75","Запорізька область","Запорізький обласний протитуберкульозний клінічний диспансер, к.85
вул.Перспективна, 2, м.Запоріжжя, 69009","452","361","93","14","79","12","91","","0","79","12","91","3","88","0","1","0","5","1","68","0","0","2","0","2","0","4","2","2","0","1","28.10.12"
"230861","75","Запорізька область","КУ ""Центральна клінічна лікарня №4"", актова зала
вул.Соціалістична, 1, м.Запоріжжя, 69106","204","151","53","17","36","17","53","","0","36","17","53","1","52","0","1","1","4","3","36","0","0","0","0","1","1","3","0","0","2","0","29.10.12"
"230917","75","Запорізька область","навчально-виховний комплекс №66, спортивна зала
вул.Рекордна, 1, м.Запоріжжя, 69006","2472","977","2478","69","1434","61","1495","","0","1434","61","1495","35","1460","15","29","18","231","17","530","12","10","136","53","220","11","117","29","7","17","8","29.10.12"
"230918","75","Запорізька область","Запорізька державна інженерна академія, хол, 1-й поверх
просп.Леніна, 226, м.Запоріжжя, 69006","2048","863","2040","34","1158","27","1185","","0","1158","27","1185","50","1135","18","24","13","188","23","359","16","1","112","18","188","8","121","15","3","15","13","29.10.12"
"230919","75","Запорізька область","багатопрофільний ліцей №62, коридор, 1-й поверх
вул.Сорок років Рад. України, 9, м.Запоріжжя, 69006","2064","812","2051","46","1212","40","1252","","0","1212","40","1252","47","1205","14","15","11","155","30","407","12","3","164","33","228","3","86","15","5","17","7","29.10.12"
"230920","75","Запорізька область","гімназія №31, коридор, 1-й поверх
вул.Добролюбова, 4, м.Запоріжжя, 69006","2236","883","2236","37","1323","30","1353","","0","1323","30","1353","47","1306","25","26","16","173","25","484","11","3","126","43","199","7","115","14","12","17","10","29.10.12"
"230921","75","Запорізька область","гімназія №50, коридор, 1-й поверх
вул.Богдана Хмельницького, 22, м.Запоріжжя, 69006","2028","848","2023","40","1151","29","1180","","0","1151","29","1180","37","1143","14","20","13","156","27","401","12","5","128","26","200","8","93","10","9","16","5","29.10.12"
"230922","75","Запорізька область","гуртожиток Запорізької державної інженерної академії, актова зала
вул.Трегубенка, 19, м.Запоріжжя, 69006","1964","834","1956","38","1101","29","1130","","0","1101","29","1130","32","1098","14","24","14","201","30","342","31","1","86","17","180","5","83","24","14","20","12","29.10.12"
"230923","75","Запорізька область","навчально-виховний комплекс №30, коридор, 1-й поверх, праворуч
вул.Леонова, 4, м.Запоріжжя, 69006","1944","724","1943","49","1183","37","1220","","0","1183","37","1220","34","1186","16","25","9","171","30","441","15","0","92","13","200","10","114","11","12","20","7","29.10.12"
"230924","75","Запорізька область","навчально-виховний комплекс №30, коридор, 1-й поверх, ліворуч
вул.Леонова, 4, м.Запоріжжя, 69006","1828","698","1815","58","1092","38","1130","","0","1092","38","1130","36","1094","12","20","10","180","25","356","20","5","100","33","177","18","82","21","15","13","7","29.10.12"
"230925","75","Запорізька область","будинок культури санаторію Великий Луг, фойє
вул.Ленська, 45, м.Запоріжжя, 69096","1184","482","1171","29","675","27","702","","0","675","27","702","17","685","11","23","10","86","11","304","23","1","43","15","104","3","34","4","5","7","1","29.10.12"
"230926","75","Запорізька область","школа №109, вестибюль
вул.Дніпровські пороги, 29, м.Запоріжжя, 69096","2488","1118","2472","28","1347","23","1370","","0","1347","23","1370","41","1329","13","26","10","171","24","480","56","6","100","26","294","8","68","19","10","12","6","29.10.12"
"230927","75","Запорізька область","школа №109, їдальня
вул.Дніпровські пороги, 29, м.Запоріжжя, 69096","2468","944","2467","32","1501","23","1524","","0","1501","23","1524","40","1484","20","30","8","286","28","479","43","16","116","28","272","3","105","20","9","14","7","29.10.12"
"230928","75","Запорізька область","школа №109, 3-й блок, 1-й поверх
вул.Дніпровські пороги, 29, м.Запоріжжя, 69096","2496","1053","2470","14","1430","13","1443","","0","1430","13","1443","32","1411","14","25","17","271","37","439","35","9","124","28","259","7","95","15","5","21","10","29.10.12"
"230929","75","Запорізька область","школа №109, 3-й блок, 2-й поверх
вул.Дніпровські пороги, 29, м.Запоріжжя, 69096","2368","956","2363","32","1391","21","1412","","0","1391","21","1412","33","1379","13","32","11","268","20","421","51","6","111","17","287","8","87","9","9","20","9","29.10.12"
"230930","75","Запорізька область","колегіум ""Елінт"", вестибюль 1
вул.Маршала Чуйкова, 29, м.Запоріжжя, 69121","2348","936","2359","36","1384","28","1412","","0","1384","28","1412","38","1374","14","19","9","262","27","437","72","7","126","13","239","5","97","16","7","16","8","29.10.12"
"230931","75","Запорізька область","колегіум ""Елінт"", вестибюль 2
вул.Маршала Чуйкова, 29, м.Запоріжжя, 69121","2276","874","2266","29","1381","21","1402","","0","1381","21","1402","49","1353","23","23","10","216","19","467","81","3","96","31","243","5","94","18","1","19","4","29.10.12"
"230932","75","Запорізька область","колегіум ""Елінт"", рекреація
вул.Маршала Чуйкова, 29, м.Запоріжжя, 69121","2448","920","2444","30","1507","21","1528","","0","1507","21","1528","40","1488","14","29","5","224","19","556","83","12","112","25","257","6","98","18","5","18","7","29.10.12"
"230933","75","Запорізька область","школа №69, спортивна зала
вул.Ладозька, 2, м.Запоріжжя, 69096","2356","988","2326","19","1352","16","1368","","0","1352","16","1368","24","1344","16","13","7","217","28","465","65","6","92","34","273","6","76","23","8","11","4","29.10.12"
"230934","75","Запорізька область","школа №69, коридор, 4-й блок
вул.Ладозька, 2, м.Запоріжжя, 69096","2400","982","2387","24","1395","23","1418","","0","1395","23","1418","45","1373","11","20","7","211","21","468","114","8","114","27","233","8","91","16","5","10","9","29.10.12"
"230935","75","Запорізька область","школа №69, коридор, 1-й поверх
вул.Ладозька, 2, м.Запоріжжя, 69096","2468","1012","2457","24","1436","20","1456","","0","1436","20","1456","37","1419","19","16","14","222","33","488","71","4","113","27","260","9","88","27","6","17","5","29.10.12"
"230936","75","Запорізька область","школа №100, рекреація біля к.114
вул.Ладозька, 2А, м.Запоріжжя, 69096","2500","1031","2504","41","1438","31","1469","","0","1437","31","1468","43","1425","17","22","13","215","16","469","70","11","101","27","288","7","110","24","8","21","6","29.10.12"
"230937","75","Запорізька область","школа №100, хол, 1-й поверх, ліворуч
вул.Ладозька, 2А, м.Запоріжжя, 69096","2376","857","2351","23","1504","15","1519","","0","1504","15","1519","38","1481","19","22","15","269","28","476","77","18","115","25","255","5","115","10","9","16","7","29.10.12"
"230938","75","Запорізька область","школа №100, хол, 1-й поверх, праворуч
вул.Ладозька, 2А, м.Запоріжжя, 69096","2376","892","2361","28","1461","23","1484","","0","1460","23","1483","56","1427","15","22","13","264","21","474","72","10","100","19","225","7","131","21","9","16","8","29.10.12"
"230939","75","Запорізька область","факультет Київського університету культури, коридор, 1-й поверх
вул.Медична, 8, м.Запоріжжя, 69096","2304","1100","2273","21","1186","18","1204","","0","1186","18","1204","35","1169","16","20","12","223","11","359","54","6","94","10","215","8","102","14","5","15","5","29.10.12"
"230940","75","Запорізька область","палац культури ""Енергетиків"", фойє 1
бульв.Вінтера, 16, м.Запоріжжя, 69096","2404","1063","2393","27","1320","21","1341","","0","1320","21","1341","46","1295","17","16","5","239","28","399","46","6","104","29","258","9","95","19","6","11","8","28.10.12"
"230941","75","Запорізька область","палац культури ""Енергетиків"", фойє 2
бульв.Вінтера, 16, м.Запоріжжя, 69096","2388","1007","2356","0","1381","0","1381","","0","1381","0","1381","35","1346","12","20","13","229","15","448","31","7","116","24","243","5","136","22","6","16","3","29.10.12"
"230942","75","Запорізька область","школа №89, рекреація, 1-й поверх, ліворуч
вул.Михайлова, 15, м.Запоріжжя, 69065","2456","1042","2442","32","1394","20","1414","","0","1394","20","1414","43","1371","20","21","13","251","26","499","42","5","92","36","225","3","98","16","7","14","3","29.10.12"
"230943","75","Запорізька область","школа №89, рекреація, 1-й поверх, праворуч
вул.Михайлова, 15, м.Запоріжжя, 69065","2252","965","2238","28","1261","26","1287","","0","1261","26","1287","38","1249","26","17","16","202","29","532","16","6","75","19","171","6","87","18","7","11","11","29.10.12"
"230944","75","Запорізька область","школа №59, актова зала
вул.Кремлівська, 10, м.Запоріжжя, 69041","2392","877","2391","38","1488","27","1515","","0","1488","27","1515","38","1477","19","14","8","273","9","457","28","16","173","29","276","2","105","14","20","18","16","29.10.12"
"230945","75","Запорізька область","школа №73, коридор, 1-й поверх, ліворуч
вул.Дудикіна, 16, м.Запоріжжя, 69065","2352","910","2347","47","1410","32","1442","","0","1410","32","1442","40","1402","15","23","18","214","19","557","24","7","135","16","174","5","130","14","12","34","5","29.10.12"
"230946","75","Запорізька область","школа №73, коридор, 1-й поверх, праворуч
вул.Дудикіна, 16, м.Запоріжжя, 69065","2368","1124","2357","35","1214","30","1244","","0","1214","30","1244","45","1199","12","14","13","173","20","456","32","3","98","12","194","7","117","16","8","17","7","29.10.12"
"230947","75","Запорізька область","школа-інтернат №4, коридор, 1-й поверх
вул.Щаслива, 2, м.Запоріжжя, 69065","2488","1126","2459","35","1332","30","1362","","0","1332","30","1362","44","1318","28","22","14","189","12","525","20","4","98","10","224","4","102","28","6","20","12","29.10.12"
"230948","75","Запорізька область","школа №61, вестибюль
вул.Братська, 25, м.Запоріжжя, 69069","2464","1145","2451","41","1290","29","1319","","0","1290","29","1319","43","1276","12","22","10","237","25","405","23","9","103","20","239","6","113","17","15","15","5","29.10.12"
"230949","75","Запорізька область","школа №61, коридор, 1-й поверх
вул.Братська, 25, м.Запоріжжя, 69069","2464","1166","2448","47","1263","35","1298","","0","1263","35","1298","59","1239","15","22","12","193","9","439","15","14","108","26","210","9","95","20","8","36","8","29.10.12"
"230950","75","Запорізька область","ПАТ ""ВІТ"", фойє, 2-й поверх
вул.Дніпропетровське шосе, 11, м.Запоріжжя, 69069","2468","1176","2439","37","1265","27","1292","","0","1265","27","1292","51","1241","16","25","12","183","16","448","16","6","83","16","204","10","128","30","9","28","11","29.10.12"
"230951","75","Запорізька область","школа №87, коридор, 1-й поверх, ліворуч
вул.Хакаська, 4, м.Запоріжжя, 69093","2112","951","2100","39","1140","21","1161","","0","1140","21","1161","30","1131","13","21","15","216","16","345","16","9","90","18","223","7","105","5","5","23","4","29.10.12"
"230952","75","Запорізька область","школа №87, коридор, 1-й поверх, праворуч
вул.Хакаська, 4, м.Запоріжжя, 69093","2364","1179","2349","27","1167","18","1185","","0","1166","18","1184","45","1139","25","29","14","154","25","421","21","2","89","16","176","5","116","9","10","24","3","29.10.12"
"230953","75","Запорізька область","школа №87, коридор, 2-й поверх, ліворуч
вул.Хакаська, 4, м.Запоріжжя, 69093","2164","1083","2140","17","1071","10","1081","","0","1071","10","1081","27","1054","17","20","8","147","21","414","22","7","109","15","139","5","79","18","7","20","6","29.10.12"
"230954","75","Запорізька область","школа №87, коридор, 2-й поверх, праворуч
вул.Хакаська, 4, м.Запоріжжя, 69093","2172","941","2156","28","1213","18","1231","","0","1213","18","1231","27","1204","16","18","7","196","20","477","22","5","67","30","169","2","116","23","4","25","7","28.10.12"
"230955","75","Запорізька область","школа №29, спортивна зала
вул.Акад. Александрова, 7, м.Запоріжжя, 69093","1964","795","1954","27","1150","19","1169","","0","1150","19","1169","29","1140","21","14","4","186","18","463","11","8","81","12","174","5","95","16","5","24","3","29.10.12"
"230956","75","Запорізька область","школа №29, актова зала
вул.Акад. Александрова, 7, м.Запоріжжя, 69093","2092","812","2081","30","1256","24","1280","","0","1256","24","1280","39","1241","12","22","10","205","23","499","13","9","72","16","212","8","92","15","7","21","5","29.10.12"
"230957","75","Запорізька область","школа №29, коридор, 2-й поверх початкової школи
вул.Акад. Александрова, 7, м.Запоріжжя, 69093","2144","904","2123","20","1223","17","1240","","0","1223","17","1240","49","1191","23","19","14","203","23","374","20","4","98","30","219","10","90","22","14","19","9","29.10.12"
"230958","75","Запорізька область","школа №29, коридор, 2-й поверх старшої школи
вул.Акад. Александрова, 7, м.Запоріжжя, 69093","1944","884","1927","20","1048","12","1060","","0","1047","12","1059","38","1021","9","20","8","161","19","405","14","1","78","17","154","6","82","17","4","22","4","29.10.12"
"230959","75","Запорізька область","школа №86, фойє нового корпусу
вул.Дегтярьова, 5Б, м.Запоріжжя, 69093","2432","1112","2420","47","1278","42","1320","","0","1277","42","1319","34","1285","21","22","24","207","13","512","21","0","52","29","229","7","101","18","4","16","9","29.10.12"
"230960","75","Запорізька область","школа №86, фойє початкової школи
вул.Дегтярьова, 5Б, м.Запоріжжя, 69093","2160","929","2136","16","1217","14","1231","","0","1217","14","1231","21","1210","21","19","11","177","16","476","12","3","97","13","204","5","103","19","11","16","7","29.10.12"
"230961","75","Запорізька область","ПАТ ""Сонячне 2007"", фойє
вул.Шушенська, 65, м.Запоріжжя, 69089","2240","1154","2231","25","1066","20","1086","","0","1066","20","1086","48","1038","18","26","17","151","14","374","20","6","53","21","181","4","109","14","4","19","7","29.10.12"
"230962","75","Запорізька область","школа №81, спортивна зала
вул.Істоміна, 18, м.Запоріжжя, 69089","1300","625","1315","24","661","14","675","","0","661","14","675","30","645","10","13","10","96","13","262","12","2","39","21","78","1","62","8","4","11","3","29.10.12"
"230963","75","Запорізька область","школа №81, коридор, 1-й поверх
вул.Істоміна, 18, м.Запоріжжя, 69089","2472","1328","2452","34","1120","24","1144","","0","1120","24","1144","44","1100","18","26","10","153","17","444","15","3","75","14","185","7","89","13","16","11","4","29.10.12"
"230964","75","Запорізька область","школа №104, фойє, ліворуч
вул.Кремлівська, 65В, м.Запоріжжя, 69041","2248","936","2229","40","1276","36","1312","","0","1276","36","1312","46","1266","14","19","13","223","15","422","24","9","144","20","216","5","90","15","5","25","7","29.10.12"
"230965","75","Запорізька область","школа №104, фойє, праворуч
вул.Кремлівська, 65В, м.Запоріжжя, 69041","2368","1055","2332","20","1300","13","1313","","0","1300","13","1313","25","1288","13","25","8","294","13","431","20","9","105","26","213","7","81","16","2","16","9","29.10.12"
"230966","75","Запорізька область","палац культури ""Запоріжтрансформатор"", хол, 1-й поверх
вул.Кремлівська, 14, м.Запоріжжя, 69041","2352","976","2330","62","1324","52","1376","","0","1324","52","1376","36","1340","14","26","9","225","15","462","22","12","141","12","211","3","143","14","2","22","7","29.10.12"
"230967","75","Запорізька область","палац культури ""Запоріжтрансформатор"", хол, 2-й поверх
вул.Кремлівська, 14, м.Запоріжжя, 69041","2404","952","2382","65","1403","49","1452","","0","1403","49","1452","45","1407","10","29","3","266","15","469","19","45","163","11","224","1","103","16","5","23","5","29.10.12"
"230968","75","Запорізька область","клінічна лікарня №9, корпус травмотології, кабінет профкому
вул.Щаслива, 1, м.Запоріжжя, 69065","668","517","169","151","16","135","151","","0","16","135","151","12","139","2","5","1","15","10","60","2","2","11","2","13","0","7","3","1","3","2","28.10.12"
"230969","75","Запорізька область","клінічна лікарня №3, хол, 1-й поверх
просп.Металургів, 9, м.Запоріжжя, 69032","264","234","32","2","29","1","30","","0","29","1","30","0","30","0","2","0","4","0","10","1","0","1","0","6","0","4","0","1","0","1","29.10.12"
"230970","75","Запорізька область","госпіталь для інвалідів ВОВ, зала засідань, 1-й поверх
вул.Ленська, 45, м.Запоріжжя, 69096","112","9","108","2","101","2","103","","0","101","2","103","9","94","1","2","3","1","1","51","2","0","2","0","15","0","13","0","0","0","3","29.10.12"
"230971","75","Запорізька область","пологовий будинок №4, актова зала
вул.Дудикіна, 9, м.Запоріжжя, 69065","116","96","23","0","20","0","20","","0","20","0","20","0","20","0","1","0","0","0","12","0","0","1","0","4","0","1","0","0","1","0","29.10.12"
