"№ ВД","OBO","Назва регіону України","Місцезнаходження та адреса приміщення для голосування","1) К-сть одержаних бюлетенів","2) К-сть невикористаних бюлетенів","3) К-сть виборців, внесених до списку виборців","4) К-сть виборців, внесених до витягу зі списку виборців","5) К-сть виборців, які отримали бюлетені у приміщенні","6) К-сть виборців, які отримали за місцем перебування","7) Сумарна к-сть виборців, які отримали бюлетені","8) К-сть бюлетенів, що виявилися у кожній скринці","9) К-сть бюлетенів, що не підлягають врахуванню","10) К-сть виборців, які взяли участь у голос. у приміщенні для гол.","11) К-сть виборців, які взяли участь у голос. за місцем перебування","12) К-сть виборців, які взяли участь у голосуванні на виборчій дільниці","13) К-сть бюлетенів, визнаних недійсними","14) Сумарна к-сть голосів виборців ЗА","Бабурін
Олексій
Олексійович","Богуслаєв
Вячеслав
Олександрович","Кващук
Ігор
Святославович","Книш
Тімур
Станіславович","Мудраченко
Олександр
Сергійович","Охріменко
Андрій
Вячеславович","Дата підписання протоколу"
"230809","77","Запорізька область","школа №76, фойє
просп.Леніна, 154Г, м.Запоріжжя, 69095","2328","1200","2302","28","1109","19","1128","","0","1109","19","1128","37","1091","259","400","36","170","36","190","29.10.12"
"230810","77","Запорізька область","Державне підприємство ""Державний проектний інститут ""Запоріжцивільпроект"", фойє
пл.Пушкіна, 4, м.Запоріжжя, 69095","2272","950","2268","65","1263","59","1322","","0","1263","59","1322","53","1269","312","465","37","215","47","193","29.10.12"
"230812","77","Запорізька область","академічний ліцей, фойє
вул.Гоголя, 155, м.Запоріжжя, 69095","2256","853","2237","52","1358","45","1403","","0","1358","45","1403","65","1338","304","500","36","212","58","228","29.10.12"
"230813","77","Запорізька область","Запорізьке обласне управління водних ресурсів, фойє
просп.Леніна, 105, м.Запоріжжя, 69095","2352","1143","2355","40","1176","33","1209","","0","1176","33","1209","54","1155","256","426","30","171","54","218","29.10.12"
"230815","77","Запорізька область","торговий коледж, актова зала
вул.Героїв Сталінграду, 1, м.Запоріжжя, 69095","2392","1015","2365","28","1356","21","1377","","0","1356","21","1377","46","1331","256","636","30","170","56","183","29.10.12"
"230816","77","Запорізька область","коледж радіоелектроніки, фойє
просп.Леніна, 117, м.Запоріжжя, 69095","2376","1096","2380","35","1254","26","1280","","0","1253","26","1279","48","1231","236","475","44","218","38","220","29.10.12"
"230817","77","Запорізька область","колегіум №98, фойє
вул.Запорізька, 1А, м.Запоріжжя, 69095","2256","979","2215","25","1255","22","1277","","0","1255","22","1277","63","1214","288","440","37","190","55","204","29.10.12"
"230818","77","Запорізька область","колегіум №98, фойє
вул.Запорізька, 1А, м.Запоріжжя, 69095","2360","898","2336","52","1419","43","1462","","0","1419","43","1462","71","1391","321","533","39","203","46","249","29.10.12"
"230819","77","Запорізька область","колегіум №98, спортивний зал
вул.Запорізька, 1А, м.Запоріжжя, 69095","2296","863","2290","29","1409","24","1433","","0","1409","24","1433","64","1369","305","482","39","207","52","284","29.10.12"
"231061","77","Запорізька область","школа №53, актова зала, 2-й поверх
вул.Шевченка, 123, м.Запоріжжя, 69039","1968","998","1965","19","951","19","970","","0","951","19","970","44","926","143","427","19","140","43","154","29.10.12"
"231062","77","Запорізька область","школа №53, частина спортивної зали, 2-й поверх
вул.Шевченка, 123, м.Запоріжжя, 69039","2104","1009","2110","22","1079","16","1095","","0","1079","16","1095","50","1045","209","419","32","159","60","166","29.10.12"
"231063","77","Запорізька область","школа №53, частина спортивної зали, 2-й поверх
вул.Шевченка, 123, м.Запоріжжя, 69039","1672","852","1664","8","813","7","820","","0","813","7","820","30","790","143","349","15","121","19","143","29.10.12"
"231064","77","Запорізька область","школа №52, актова зала, 1-й поверх
вул.Шевченка, 241, м.Запоріжжя, 69007","2456","1206","2463","43","1208","42","1250","","0","1208","42","1250","41","1209","265","529","23","177","23","192","29.10.12"
"231065","77","Запорізька область","школа №52, коридор, 2-й поверх
вул.Шевченка, 241, м.Запоріжжя, 69007","2440","1069","2448","57","1320","51","1371","","0","1320","51","1371","50","1321","222","707","33","160","28","171","29.10.12"
"231066","77","Запорізька область","школа №42, медичний пункт, 1-й поверх
вул.Шевченка, 277, м.Запоріжжя, 69007","1744","767","1746","16","963","14","977","","0","963","14","977","48","929","179","491","17","115","15","112","29.10.12"
"231067","77","Запорізька область","школа №42, каб.102, 1-й поверх
вул.Шевченка, 277, м.Запоріжжя, 69007","1696","851","1690","19","827","18","845","","0","827","18","845","43","802","143","400","21","98","37","103","29.10.12"
"231068","77","Запорізька область","школа №42, каб.103, 1-й поверх
вул.Шевченка, 277, м.Запоріжжя, 69007","1736","938","1728","14","784","14","798","","0","784","14","798","29","768","122","383","19","120","20","104","29.10.12"
"231069","77","Запорізька область","школа №77, актова зала, 3-й поверх
вул.Памірська, 91, м.Запоріжжя, 69081","2400","1158","2406","30","1215","27","1242","","0","1215","27","1242","63","1179","223","609","27","120","35","165","29.10.12"
"231070","77","Запорізька область","вище професійне училище ""Моторобудівник"", рекреація, 1-й поверх
вул.Панфьорова, 146А, м.Запоріжжя, 69081","2450","1209","2436","14","1228","13","1241","","0","1228","13","1241","52","1189","246","631","26","108","52","126","29.10.12"
"231071","77","Запорізька область","школа №60, рекреація, 2-й поверх
вул.Уральська, 27, м.Запоріжжя, 69068","1304","657","1300","8","641","6","647","","0","641","6","647","28","619","100","304","9","89","16","101","29.10.12"
"231072","77","Запорізька область","навчально-виховний комплекс ""Світанок"", спортивна зала, 1-й поверх
вул.Грязнова, 92А, м.Запоріжжя, 69068","2320","1001","2314","16","1307","12","1319","","0","1307","12","1319","57","1262","247","600","24","158","37","196","29.10.12"
"231073","77","Запорізька область","ліцей ""Перспектива"", корпус №2, актова зала, 2-й поверх
вул.Уральська, 3Б, м.Запоріжжя, 69068","2224","1080","2242","16","1132","12","1144","","0","1132","12","1144","56","1088","170","496","34","160","46","182","29.10.12"
"231074","77","Запорізька область","школа №60, рекреація, 1-й поверх
вул.Уральська, 27, м.Запоріжжя, 69068","1696","829","1678","12","855","12","867","","0","855","12","867","36","831","135","391","19","117","23","146","29.10.12"
"231075","77","Запорізька область","школа №12, актова зала, 1-й поверх
просп.Моторобудівників, 60, м.Запоріжжя, 69068","2104","743","2070","11","1352","9","1361","","0","1352","9","1361","46","1315","150","879","13","116","27","130","29.10.12"
"231076","77","Запорізька область","школа №12, гардероб, 1-й поверх
просп.Моторобудівників, 60, м.Запоріжжя, 69068","2192","857","2164","27","1309","26","1335","","0","1309","26","1335","31","1304","166","832","26","122","30","128","29.10.12"
"231077","77","Запорізька область","авіаційний коледж імені О.Г.Івченка, спортивна зала, 1-й поверх
вул.Іванова, 97, м.Запоріжжя, 69068","1848","711","1845","6","1132","5","1137","","0","1132","5","1137","30","1107","157","668","19","122","30","111","29.10.12"
"231078","77","Запорізька область","авіаційний коледж імені О.Г.Івченка, актова зала, 1-й поверх
вул.Іванова, 97, м.Запоріжжя, 69068","2104","833","2128","26","1249","22","1271","","0","1249","22","1271","44","1227","167","691","23","145","38","163","29.10.12"
"231079","77","Запорізька область","обласний центр еколого-натуралістичної творчості учнівської молоді, виставкова зала
вул.Чарівна, 11, м.Запоріжжя, 69068","2184","629","2164","3","1553","2","1555","","0","1553","2","1555","43","1512","159","1018","20","134","30","151","29.10.12"
"231080","77","Запорізька область","школа №63, рекреація №1, 1-й поверх
вул.Пархоменка, 12А, м.Запоріжжя, 69071","2184","1050","2157","4","1131","3","1134","","0","1131","3","1134","32","1102","139","637","28","134","28","136","29.10.12"
"231081","77","Запорізька область","школа №63, рекреація №2, 1-й поверх
вул.Пархоменка, 12А, м.Запоріжжя, 69071","2032","749","2025","11","1273","10","1283","","0","1273","10","1283","55","1227","175","672","37","152","23","168","29.10.12"
"231082","77","Запорізька область","школа №63, рекреація №3, 1-й поверх
вул.Пархоменка, 12А, м.Запоріжжя, 69071","2160","897","2134","8","1256","7","1263","","0","1256","7","1263","52","1211","211","669","20","131","31","149","29.10.12"
"231083","77","Запорізька область","школа №35 ""Вибір"", рекреація №1, 1-й поверх
вул.Пархоменка, 19, м.Запоріжжя, 69071","2136","875","2104","17","1247","14","1261","","0","1247","14","1261","63","1198","248","540","31","176","35","168","29.10.12"
"231084","77","Запорізька область","школа №35 ""Вибір"", спортивна зала, 1-й поверх
вул.Пархоменка, 19, м.Запоріжжя, 69071","2352","1041","2390","10","1303","8","1311","","0","1303","8","1311","68","1241","213","661","30","132","34","171","29.10.12"
"231085","77","Запорізька область","школа №35 ""Вибір"", рекреація, 1-й поверх
вул.Пархоменка, 19, м.Запоріжжя, 69071","2216","914","2201","30","1276","26","1302","","0","1276","26","1302","47","1255","220","622","35","171","31","176","29.10.12"
"231086","77","Запорізька область","школа №35 ""Вибір"", актова зала, 2-й поверх
вул.Пархоменка, 19, м.Запоріжжя, 69071","2184","978","2167","28","1183","23","1206","","0","1183","23","1206","55","1151","244","555","31","149","44","128","29.10.12"
"231087","77","Запорізька область","школа №101, фойє, 1-й поверх
вул.Бочарова, 10Б, м.Запоріжжя, 69098","2040","851","2037","15","1178","11","1189","","0","1178","11","1189","58","1131","207","568","36","129","49","142","29.10.12"
"231088","77","Запорізька область","школа №101, їдальня, 1-й поверх
вул.Бочарова, 10Б, м.Запоріжжя, 69098","2104","923","2092","6","1176","5","1181","","0","1176","5","1181","39","1142","201","518","31","167","66","159","29.10.12"
"231089","77","Запорізька область","гімназія №93, рекреація №1, 1-й поверх
вул.Полякова, 9, м.Запоріжжя, 69098","2272","933","2262","22","1320","19","1339","","0","1320","19","1339","56","1283","189","637","31","192","50","184","29.10.12"
"231090","77","Запорізька область","гімназія №93, рекреація №2, 1-й поверх
вул.Полякова, 9, м.Запоріжжя, 69098","2160","895","2151","23","1245","20","1265","","0","1245","20","1265","54","1211","228","603","17","168","54","141","29.10.12"
"231091","77","Запорізька область","центр дитячої та юнацької творчості, каб.110, 1-й поверх
вул.Чарівна, 157В, м.Запоріжжя, 69098","2176","885","2166","20","1276","15","1291","","0","1276","15","1291","62","1229","223","535","30","203","50","188","29.10.12"
"231092","77","Запорізька область","ліцей №34, 1-й блок, 1-й поверх
вул.Мікояна, 8, м.Запоріжжя, 69120","2192","925","2178","18","1252","15","1267","","0","1252","15","1267","35","1232","187","586","27","187","42","203","29.10.12"
"231093","77","Запорізька область","ліцей №34, 2-й блок, 1-й поверх
вул.Мікояна, 8, м.Запоріжжя, 69120","1984","833","1983","11","1141","10","1151","","0","1141","10","1151","37","1114","200","509","25","143","51","186","29.10.12"
"231094","77","Запорізька область","ліцей №34, 3-й блок, 1-й поверх
вул.Мікояна, 8, м.Запоріжжя, 69120","2272","939","2279","13","1320","13","1333","","0","1320","13","1333","58","1275","215","570","27","210","60","193","29.10.12"
"231095","77","Запорізька область","ліцей №34, мала спортивна зала, 1-й поверх
вул.Мікояна, 8, м.Запоріжжя, 69120","2216","860","2215","19","1340","16","1356","","0","1340","16","1356","55","1301","211","619","33","183","46","209","29.10.12"
"231096","77","Запорізька область","школа №95, спортивна зала, 1-й поверх
вул.Мікояна, 16, м.Запоріжжя, 69120","2192","1003","2179","14","1176","13","1189","","0","1176","13","1189","49","1140","233","522","23","157","30","175","29.10.12"
"231097","77","Запорізька область","школа №95, рекреація, 1-й поверх
вул.Мікояна, 16, м.Запоріжжя, 69120","2128","949","2113","8","1175","4","1179","","0","1175","4","1179","42","1137","231","539","28","145","46","148","29.10.12"
"231098","77","Запорізька область","школа №95, фойє, 1-й поверх
вул.Мікояна, 16, м.Запоріжжя, 69120","2152","883","2142","12","1258","11","1269","","0","1258","11","1269","65","1204","232","551","23","182","43","173","29.10.12"
"231099","77","Запорізька область","будинок культури ім.Т.Г.Шевченка, зал ритмики, 1-й поверх
вул.Червона, 24А, м.Запоріжжя, 69068","2232","717","2213","19","1499","16","1515","","0","1499","16","1515","40","1475","168","980","23","137","36","131","29.10.12"
"231100","77","Запорізька область","будинок культури ім.Т.Г.Шевченка, паркетний зал, 2-й поверх
вул.Червона, 24А, м.Запоріжжя, 69068","2088","709","2068","22","1359","20","1379","","0","1359","20","1379","47","1332","150","871","19","132","24","136","29.10.12"
"231101","77","Запорізька область","школа №65, фойє, 1-й поверх
просп.Моторобудівників, 26, м.Запоріжжя, 69068","2168","648","2157","28","1497","23","1520","","0","1497","23","1520","32","1488","178","892","22","198","44","154","29.10.12"
"231102","77","Запорізька область","школа №65, рекреація, 1-й поверх
просп.Моторобудівників, 26, м.Запоріжжя, 69068","2080","691","2060","9","1380","9","1389","","0","1380","9","1389","47","1342","149","826","30","150","37","150","29.10.12"
"231103","77","Запорізька область","училище професійної підготовки працівників міліції, к.4, 1-й поверх
вул.Севастопольська, 26, м.Запоріжжя, 69092","1272","745","1272","15","515","12","527","","0","515","12","527","20","506","100","257","14","62","13","60","29.10.12"
"231104","77","Запорізька область","училище професійної підготовки працівників міліції, к.2, 2-й поверх
вул.Севастопольська, 26, м.Запоріжжя, 69092","1768","1084","1760","20","666","18","684","","0","666","18","684","35","649","140","318","15","62","17","97","29.10.12"
"231105","77","Запорізька область","школа №68, спортивна зала, 1-й поверх
вул.Харчова, 35, м.Запоріжжя, 69014","1984","1042","1978","23","925","17","942","","0","925","17","942","44","898","174","456","24","112","30","102","29.10.12"
"231106","77","Запорізька область","школа №68, рекреація, 1-й поверх
вул.Харчова, 35, м.Запоріжжя, 69014","2032","991","2038","22","1028","13","1041","","0","1028","13","1041","47","994","177","530","22","101","40","124","29.10.12"
"231107","77","Запорізька область","машинобудівне вище професійне училище, фойє, 1-й поверх
вул.Виробнича, 15, м.Запоріжжя, 69014","2264","1043","2266","19","1208","13","1221","","0","1207","13","1220","40","1180","196","576","24","186","34","164","29.10.12"
"231108","77","Запорізька область","школа №4, актова зала, 3-й поверх
вул.Волзька, 27, м.Запоріжжя, 69014","1688","788","1675","38","864","36","900","","0","864","36","900","40","860","151","433","13","120","24","119","29.10.12"
"231109","77","Запорізька область","будинок культури ПАТ ""Запорізький абразивний комбінат"", фойє, ліворуч, 2-й поверх
вул.Димитрова, 44, м.Запоріжжя, 69014","1816","906","1827","35","876","34","910","","0","876","34","910","29","881","147","488","16","100","38","92","29.10.12"
"231110","77","Запорізька область","будинок культури ПАТ ""Запорізький абразивний комбінат"", фойє, праворуч, 2-й поверх
вул.Димитрова, 44, м.Запоріжжя, 69014","1704","819","1678","12","875","10","885","","0","875","10","885","28","857","151","475","20","71","33","107","29.10.12"
"231111","77","Запорізька область","професійний ліцей, фойє, 1-й поверх
вул.Миколи Краснова, 8, м.Запоріжжя, 69014","1896","876","1882","23","999","21","1020","","0","999","21","1020","37","983","174","543","26","101","41","98","29.10.12"
"231112","77","Запорізька область","школа №55, каб.1, 1-й поверх
вул.Передатна, 17А, м.Запоріжжя, 69026","2008","1132","2005","13","864","12","876","","0","864","12","876","41","835","145","428","19","88","41","114","29.10.12"
"231113","77","Запорізька область","школа №55, мала спортивна зала, 1-й поверх
вул.Передатна, 17А, м.Запоріжжя, 69026","1856","1075","1863","16","768","13","781","","0","766","13","779","39","740","137","362","24","59","26","132","29.10.12"
"231114","77","Запорізька область","школа №64, кабінет народознавства, 1-й поверх
вул.Молочна, 36, м.Запоріжжя, 69060","2448","1341","2459","23","1089","18","1107","","0","1089","18","1107","40","1067","195","456","26","176","31","183","29.10.12"
"231115","77","Запорізька область","школа №64, спортивна зала, 1-й поверх
вул.Молочна, 36, м.Запоріжжя, 69060","2376","1299","2367","11","1067","10","1077","","0","1067","10","1077","48","1029","218","540","20","78","39","134","29.10.12"
"231116","77","Запорізька область","школа №19, спортивна зала, 1-й поверх
вул.Військбуд, 13, м.Запоріжжя, 69013","1800","1018","1803","31","753","29","782","","0","753","29","782","33","749","138","378","14","83","19","117","29.10.12"
"231117","77","Запорізька область","школа №19, музична зала, 1-й поверх
вул.Військбуд, 13, м.Запоріжжя, 69013","2336","1169","2285","10","1158","9","1167","","0","1158","9","1167","53","1114","228","607","18","85","44","132","29.10.12"
"231118","77","Запорізька область","школа №19, фойє, 1-й поверх
вул.Військбуд, 13, м.Запоріжжя, 69013","2272","1111","2245","5","1157","4","1161","","0","1157","4","1161","34","1127","240","640","10","82","34","121","29.10.12"
"231119","77","Запорізька область","школа №111, спортивна зала, 1-й поверх
вул.Центральна, 8А, м.Запоріжжя, 69061","1896","939","1896","12","945","12","957","","0","944","12","956","49","907","200","470","19","85","25","108","29.10.12"
"231120","77","Запорізька область","клуб, зала №1
вул.Мокрянський кар’єр-2, клуб, м.Запоріжжя, 69038","280","145","277","2","133","2","135","","0","133","2","135","4","131","41","76","1","4","0","9","29.10.12"
"231121","77","Запорізька область","міська клінічна лікарня №2, фізіотерапевтичний кабінет №1, 1-й поверх
вул.Брюллова, 6, м.Запоріжжя, 69068","160","81","85","6","74","5","79","","0","74","5","79","7","72","18","39","1","7","3","4","28.10.12"
"231122","77","Запорізька область","медико-санітарна частина ПАТ ""Мотор Січ"", актова зала, 1-й поверх
вул.Брюллова, 6, м.Запоріжжя, 69068","304","213","91","16","75","16","91","","0","75","16","91","0","91","2","76","0","5","2","6","29.10.12"
"231123","77","Запорізька область","пологовий будинок №3, актова зала, 2-й поверх
вул.Бочарова, 11, м.Запоріжжя, 69071","128","70","59","0","58","0","58","","0","58","0","58","5","53","5","42","1","2","0","3","29.10.12"
"231124","77","Запорізька область","міська лікарня №8, фойє поліклініки, 2-й поверх
вул.Харчова, 2, м.Запоріжжя, 69014","64","13","51","7","44","7","51","","0","44","7","51","1","50","3","39","1","2","2","3","29.10.12"
