"№ ВД","OBO","Назва регіону України","Місцезнаходження та адреса приміщення для голосування","1) К-сть одержаних бюлетенів","2) К-сть невикористаних бюлетенів","3) К-сть виборців, внесених до списку виборців","4) К-сть виборців, внесених до витягу зі списку виборців","5) К-сть виборців, які отримали бюлетені у приміщенні","6) К-сть виборців, які отримали за місцем перебування","7) Сумарна к-сть виборців, які отримали бюлетені","8) К-сть бюлетенів, що виявилися у кожній скринці","9) К-сть бюлетенів, що не підлягають врахуванню","10) К-сть виборців, які взяли участь у голос. у приміщенні для гол.","11) К-сть виборців, які взяли участь у голос. за місцем перебування","12) К-сть виборців, які взяли участь у голосуванні на виборчій дільниці","13) К-сть бюлетенів, визнаних недійсними","14) Сумарна к-сть голосів виборців ЗА","Драніков
Олександр
Едуардович","Дудка
Олександр
Іванович","Кривохатько
Вадим
Вікторович","Кузьменко
Олег
Анатолійович","Куценко
Владислав
Ігорович","Мараховська
Вікторія
Юріївна","Дата підписання протоколу"
"000001","82","Запорізька область","корпусне відділення №2 Вільнянського слідчого ізолятора
вул.Зелена, 34, смт Кам’яне, Вільнянський р-н, Запорізька обл., 70050","824","10","816","0","814","0","814","","0","814","0","814","158","656","35","484","45","24","41","27","29.10.12"
"230116","82","Запорізька область","школа №2, вестибюль
пров.Новий, 7, м.Вільнянськ, Вільнянський р-н, Запорізька обл., 70002","2200","860","2174","36","1312","28","1340","","0","1311","28","1339","47","1292","7","210","937","10","28","100","29.10.12"
"230117","82","Запорізька область","школа-інтернат, вестибюль
пров.Шкільний, 5, м.Вільнянськ, Вільнянський р-н, Запорізька обл., 70002","1792","793","1782","44","971","28","999","","0","971","28","999","37","962","6","172","656","7","28","93","29.10.12"
"230118","82","Запорізька область","гімназія, вестибюль
вул.Бочарова, 14, м.Вільнянськ, Вільнянський р-н, Запорізька обл., 70002","2480","973","2460","39","1475","32","1507","","0","1475","32","1507","43","1464","11","245","1070","10","18","110","29.10.12"
"230119","82","Запорізька область","школа №3, актова зала
вул.Бочарова, 13, м.Вільнянськ, Вільнянський р-н, Запорізька обл., 70002","2464","1031","2351","76","1369","64","1433","","0","1369","64","1433","37","1396","10","253","1023","3","20","87","29.10.12"
"230120","82","Запорізька область","будинок культури, танцювальна зала
вул.Радянська, 6, м.Вільнянськ, Вільнянський р-н, Запорізька обл., 70002","2224","975","2194","57","1211","38","1249","","0","1211","38","1249","37","1212","7","234","814","15","18","124","29.10.12"
"230121","82","Запорізька область","ліцей, вестибюль
вул.Космодем’янської, 3, м.Вільнянськ, Вільнянський р-н, Запорізька обл., 70002","2232","1015","2238","51","1170","47","1217","","0","1170","47","1217","38","1179","6","195","867","9","26","76","29.10.12"
"230122","82","Запорізька область","будинок культури, фойє
вул.Центральна, 9А, смт Кам'яне, Вільнянський р-н, Запорізька обл., 70050","1104","408","1100","37","664","32","696","","0","664","32","696","24","672","2","170","467","3","7","23","28.10.12"
"230123","82","Запорізька область","школа, вестибюль
вул.Леніна, 27, с.Антонівка, Вільнянський р-н, Запорізька обл., 70040","600","253","591","46","314","33","347","","0","314","33","347","20","327","2","83","217","2","8","15","29.10.12"
"230124","82","Запорізька область","школа, спортивна зала
вул.Центральна, 5, с.Гнаровське, Вільнянський р-н,Запорізька обл., 70017","944","464","933","50","438","42","480","","0","438","42","480","33","447","11","181","149","9","41","56","29.10.12"
"230125","82","Запорізька область","будинок культури, кімната поштового відділення
вул.60 років ВЛКСМ, 42Б, с.Дніпровка, Вільнянський р-н, Запорізька обл., 70014","864","334","858","50","482","48","530","","0","482","48","530","18","512","16","194","219","12","24","47","28.10.12"
"230126","82","Запорізька область","школа, спортивна зала
вул.Олімпійська, 6, с.Дружелюбівка, Вільнянський р-н, Запорізька обл., 70053","1160","566","1153","59","546","48","594","","0","546","48","594","33","561","5","147","331","9","29","40","29.10.12"
"230127","82","Запорізька область","школа, вестибюль
вул.Шкільна, 5А, с.Кірова, Вільнянський р-н, Запорізька обл., 70026","696","282","687","48","371","43","414","","0","371","43","414","29","385","3","128","219","0","18","17","29.10.12"
"230128","82","Запорізька область","будинок культури, обрядова зала
вул.Молодіжна, 1А, с.Купріянівка, Вільнянський р-н, Запорізька обл., 70054","720","244","715","52","427","49","476","","0","427","49","476","14","462","1","76","370","2","4","9","29.10.12"
"230129","82","Запорізька область","школа, спортивна зала
вул.Дзержинського, 95А, с.Любимівка, Вільнянський р-н, Запорізька обл., 70033","784","354","782","90","349","81","430","","0","348","81","429","10","419","12","156","201","6","25","19","29.10.12"
"230130","82","Запорізька область","навчально-виховний комплекс, вестибюль
вул.Шкільна, 1Е, с.Люцерна, Вільнянський р-н, Запорізька обл., 70037","904","313","897","22","573","18","591","","0","573","18","591","18","573","12","290","152","17","65","37","29.10.12"
"230131","82","Запорізька область","школа, к.2
вул.Гагаріна, 26А, с.Богатирівка, Вільнянський р-н, Запорізька обл., 70036","1056","518","1050","36","513","25","538","","0","513","25","538","46","492","32","206","91","47","55","61","28.10.12"
"230132","82","Запорізька область","адміністративний будинок сільської ради, актова зала
вул.Центральна, 18, с.Максимівка, Вільнянський р-н, Запорізька обл., 70024","568","222","564","45","308","38","346","","0","308","38","346","15","331","1","78","195","5","8","44","29.10.12"
"230133","82","Запорізька область","школа-сад, актова зала
вул.Нова, 1, с.Уральске, Вільнянський р-н, Запорізька обл., 70025","328","129","327","13","187","12","199","","0","187","12","199","8","191","0","76","97","6","6","6","28.10.12"
"230134","82","Запорізька область","будинок культури, танцювальна зала
вул.Леніна, 77В, с.Матвіївка, Вільнянський р-н, Запорізька обл., 70035","1872","860","1838","37","976","36","1012","","0","976","36","1012","55","957","15","284","408","31","82","137","29.10.12"
"230135","82","Запорізька область","будинок народної творчості, актова зала
вул.Леніна, 408Д, с.Матвіївка, Вільнянський р-н, Запорізька обл., 70035","1024","432","1020","57","535","57","592","","0","535","57","592","41","551","11","223","186","18","50","63","29.10.12"
"230136","82","Запорізька область","будинок культури, фойє
вул.Слободчикова, 13, с.Михайлівка, Вільнянський р-н, Запорізька обл., 70030","2176","964","2159","29","1184","28","1212","","0","1184","28","1212","59","1153","36","339","518","20","96","144","29.10.12"
"230137","82","Запорізька область","сільський клуб, актова зала
вул.Першотравнева, 40В, с.Соколівка, Вільнянський р-н, Запорізька обл., 70031","768","353","770","56","362","53","415","","0","362","53","415","25","390","2","180","149","7","19","33","29.10.12"
"230138","82","Запорізька область","будинок пошти, актова зала
вул.Дніпровська, 84Б, с.Вільноандріївка, Вільнянський р-н, Запорізька обл., 70032","592","210","583","23","359","23","382","","0","359","23","382","25","357","9","178","48","12","37","73","29.10.12"
"230139","82","Запорізька область","школа, вестибюль
вул.Космічна, 43, с.Михайло-Лукашеве, Вільнянський р-н, Запорізька обл., 70042","928","362","859","49","519","47","566","","0","519","47","566","23","543","4","133","302","3","9","92","28.10.12"
"230140","82","Запорізька область","сільський клуб, актова зала
вул.Миру, 3, с.Миролюбівка, Вільнянський р-н, Запорізька обл., 70043","328","118","301","21","192","18","210","","0","192","18","210","13","197","3","61","91","1","17","24","29.10.12"
"230141","82","Запорізька область","школа, спортивна зала
вул.Миру, 22, с.Московка, Вільнянський р-н, Запорізька обл., 70044","648","190","646","42","424","34","458","","0","424","34","458","6","452","1","57","382","1","4","7","29.10.12"
"230142","82","Запорізька область","школа, спортивна зала
вул.Шкільна, 23, с.Новогупалівка, Вільнянський р-н,Запорізька обл., 70020","896","446","885","39","414","36","450","","0","414","36","450","15","435","3","137","250","9","11","25","28.10.12"
"230143","82","Запорізька область","школа, вестибюль
вул.Польова, 34, с.Нововасилівка, Вільнянський р-н, Запорізька обл., 70005","1104","527","1094","76","510","67","577","","0","510","67","577","26","551","5","122","386","2","9","27","28.10.12"
"230144","82","Запорізька область","фельдшерсько-акушерський пункт, кімната прийому громадян
вул.Травнева, 53, с.Біляївка, Вільнянський р-н, Запорізька обл., 70002","872","497","867","57","326","49","375","","0","326","49","375","23","352","6","97","190","11","23","25","29.10.12"
"230145","82","Запорізька область","адміністративний будинок сільської ради, актова зала
вул.Леніна, 84, с.Петро-Михайлівка, Вільнянський р-н, Запорізька обл., 70015","1120","468","1104","64","597","55","652","","0","597","55","652","48","604","15","224","178","17","30","140","28.10.12"
"230146","82","Запорізька область","фельдшерсько-акушерський пункт, кімната прийому громадян
вул.Центральна, 4, с.Улянівка, Вільнянський р-н, Запорізька обл., 70015","288","114","281","36","143","31","174","","0","143","31","174","11","163","11","74","38","4","8","28","28.10.12"
"230147","82","Запорізька область","школа, вестибюль
вул.Шкільна, 22, с.Привільне, Вільнянський р-н, Запорізька обл., 70022","736","404","721","42","297","35","332","","0","297","35","332","17","315","2","81","181","5","20","26","28.10.12"
"230148","82","Запорізька область","будинок культури, актова зала
вул.Леніна, 10, с.Солоне, Вільнянський р-н, Запорізька обл., 70021","1032","496","1014","13","529","7","536","","0","529","7","536","35","501","1","181","179","9","54","77","28.10.12"
"230149","82","Запорізька область","адміністративний будинок сільської ради, актова зала
вул.Центральна, 4, с.Тернівка, Вільнянський р-н, Запорізька обл., 70010","528","248","518","32","251","29","280","","0","251","29","280","14","266","2","105","105","4","12","38","28.10.12"
"230150","82","Запорізька область","фельдшерсько-акушерський пункт, фойє
вул.Свободи, 15А, с.Великодубове, Вільнянський р-н, Запорізька обл., 70010","224","90","221","30","110","24","134","","0","110","24","134","5","129","1","72","26","2","9","19","28.10.12"
"230151","82","Запорізька область","психоневрологічний інтернат, медичний пункт, актова зала
вул.Жовтнева, 27А, с.Любомирівка, Вільнянський р-н, Запорізька обл., 70026","144","13","155","47","87","44","131","","0","87","44","131","39","92","13","55","9","7","7","1","28.10.12"
"230152","82","Запорізька область","Вільнянська виправна колонія №20, їдальня
вул.Дзержинського, 1, м.Вільнянськ, Вільнянський р-н, Запорізька обл., 70002","1552","140","1412","103","1309","103","1412","","0","1309","103","1412","303","1109","92","623","123","66","100","105","28.10.12"
"230153","82","Запорізька область","Софіївська виправна колонія №55, клуб
вул.Металістів, 1, м.Вільнянськ, Вільнянський р-н, Запорізька обл., 70002","1272","93","1194","75","1104","75","1179","","0","1104","75","1179","172","1007","46","678","90","39","80","74","29.10.12"
"230154","82","Запорізька область","Кам’янська виправна колонія №101, клуб
вул.Зелена, 32, смт Кам’яне, Вільнянський р-н, Запорізька обл., 70050","1448","87","1361","0","1361","0","1361","","0","1361","0","1361","152","1209","42","852","83","41","83","108","29.10.12"
"230155","82","Запорізька область","Дружелюбівський виправний центр №1, гуртожиток для засуджених, 1-й поверх
вул.Зелена, 1, смт Кам’яне, Вільнянський р-н, Запорізька обл., 70050","264","48","216","0","216","0","216","","0","216","0","216","40","176","6","143","11","2","5","9","28.10.12"
"230156","82","Запорізька область","Марфопільський фельдшерсько-акушерський пункт, к.2
вул.Челюскіна, 6А, с.Марфопіль, Гуляйпільський р-н, Запорізька обл., 70206","200","67","193","13","120","13","133","","0","120","13","133","5","128","18","50","12","6","27","15","29.10.12"
"230157","82","Запорізька область","адміністративний будинок тракторної бригади ТОВ ""Еталон-Агро-Плюс"", к.2
адміністративний будинок тракторної бригади ТОВ ""Еталон-Агро-Плюс"", с.Зелений Гай, Гуляйпільський р-н, Запорізька обл., 70242","144","48","138","16","80","16","96","","0","80","16","96","0","96","2","75","9","1","7","2","28.10.12"
"230158","82","Запорізька область","Піщанський фельдшерсько-акушерський пункт, к.2
вул.9 Січня, 337, м.Гуляйполе, Гуляйпільський р-н, Запорізька обл., 70201","992","446","981","32","516","30","546","","0","516","30","546","34","512","39","165","109","18","100","81","28.10.12"
"230159","82","Запорізька область","адміністративний будинок ПАТ ""Аграрний дім"", актова зала
вул.9 Січня, 125, м.Гуляйполе, Гуляйпільський р-н, Запорізька обл., 70201","1560","720","1544","29","813","27","840","","0","813","27","840","41","799","111","335","163","24","98","68","29.10.12"
"230160","82","Запорізька область","адміністративний будинок ТОВ ""Вишневе"", вестибюль
вул.9 Січня, 110, м.Гуляйполе, Гуляйпільський р-н, Запорізька обл., 70202","832","418","820","22","394","20","414","","0","394","20","414","18","396","32","174","74","16","62","38","29.10.12"
"230161","82","Запорізька область","школа №1, актова зала
вул.Леніна, 48, м.Гуляйполе, Гуляйпільський р-н, Запорізька обл., 70202","1512","702","1482","52","763","47","810","","0","763","47","810","39","771","80","392","116","14","96","73","29.10.12"
"230162","82","Запорізька область","культурно-спортивний комплекс ""Сучасник"", к.104
пл.Петровського, 2, м.Гуляйполе, Гуляйпільський р-н, Запорізька обл., 70202","1848","835","1834","32","983","30","1013","","0","983","30","1013","31","982","116","451","157","18","142","98","29.10.12"
"230163","82","Запорізька область","колегіум ""Лідер"", спортивна зала
вул.Цвітна, 5, м.Гуляйполе, Гуляйпільський р-н, Запорізька обл., 70202","1696","741","1675","51","910","45","955","","0","910","45","955","32","923","97","448","167","18","97","96","29.10.12"
"230164","82","Запорізька область","клуб ТОВ ""Новий заповіт"", вестибюль
вул.Спортивна, 6, м.Гуляйполе, Гуляйпільський р-н, Запорізька обл., 70203","1648","691","1644","67","891","66","957","","0","891","66","957","34","923","69","408","180","21","134","111","29.10.12"
"230165","82","Запорізька область","школа №2, спортивна зала
вул.Вербова, 2, м.Гуляйполе, Гуляйпільський р-н, Запорізька обл., 70203","912","443","906","28","443","26","469","","0","443","26","469","19","450","13","195","82","17","88","55","29.10.12"
"230166","82","Запорізька область","адміністративний будинок ВАТ АТП-12338, актова зала
вул.Дачна, 4, м.Гуляйполе, Гуляйпільський р-н, Запорізька обл., 70202","768","363","754","19","388","17","405","","0","388","17","405","23","382","55","199","43","12","48","25","29.10.12"
"230167","82","Запорізька область","адміністративний будинок ТОВ ""Еталон-Агро-Плюс"", вестибюль
вул.Шкільна, 42, м.Гуляйполе, Гуляйпільський р-н, Запорізька обл., 70202","1152","559","1129","37","559","34","593","","0","559","34","593","15","578","73","298","78","7","64","58","29.10.12"
"230168","82","Запорізька область","адміністративний будинок селищної ради, зала засідань
вул.Ватутіна, 20, смт Залізничне, Гуляйпільський р-н, Запорізька обл., 70231","744","299","731","41","409","36","445","","0","409","36","445","26","419","13","206","67","17","67","49","29.10.12"
"230169","82","Запорізька область","школа, вестибюль
вул.Леніна, 40, с.Воздвижівка, Гуляйпільський р-н, Запорізька обл., 70220","888","371","867","96","434","83","517","","0","434","83","517","27","490","33","350","33","15","24","35","29.10.12"
"230170","82","Запорізька область","сільський будинок культури, вестибюль
вул.Леніна, 72, с.Верхня Терса, Гуляйпільський р-н, Запорізька обл., 70224","800","238","787","69","500","62","562","","0","500","62","562","31","531","43","306","73","6","68","35","29.10.12"
"230171","82","Запорізька область","школа, їдальня
вул.Перемоги, 57А, с.Добропілля, Гуляйпільський р-н, Запорізька обл., 70221","568","197","577","59","318","53","371","","0","318","53","371","24","347","23","219","40","7","38","20","29.10.12"
"230172","82","Запорізька область","сільський будинок культури, вестибюль
вул.Леніна, 63, с.Долинка, Гуляйпільський р-н, Запорізька обл., 70223","448","129","445","44","278","41","319","","0","278","41","319","12","307","62","149","33","3","35","25","29.10.12"
"230173","82","Запорізька область","сільський будинок культури, к.3
вул.Гагаріна, 38, с.Дорожнянка, Гуляйпільський р-н, Запорізька обл., 70234","248","72","245","20","157","19","176","","0","157","19","176","10","166","47","67","23","4","9","16","28.10.12"
"230174","82","Запорізька область","сільський будинок культури, к.1
вул.Леніна, 32, с.Комсомольське, Гуляйпільський р-н, Запорізька обл., 70232","736","277","726","61","400","59","459","","0","400","59","459","6","453","18","280","43","7","57","48","28.10.12"
"230175","82","Запорізька область","сільський будинок культури, зала
вул.Калініна, 21, с.Любимівка, Гуляйпільський р-н, Запорізька обл., 70245","592","190","585","47","362","40","402","","0","362","40","402","22","380","22","187","42","27","75","27","29.10.12"
"230176","82","Запорізька область","школа, спортивна зала
вул.Космічна, 25, с.Малинівка, Гуляйпільський р-н, Запорізька обл., 70245","528","145","519","46","338","45","383","","0","338","45","383","8","375","35","250","28","9","39","14","28.10.12"
"230177","82","Запорізька область","адміністративний будинок сільської ради, зала засідань
вул.Леніна, 12Б, с.Мирне, Гуляйпільський р-н, Запорізька обл., 70233","424","152","420","22","256","16","272","","0","256","16","272","12","260","7","157","26","8","44","18","28.10.12"
"230178","82","Запорізька область","адміністративний будинок сільської ради, зала засідань
вул.Леніна, 57, с.Новозлатопіль, Гуляйпільський р-н, Запорізька обл., 70244","648","195","640","37","417","36","453","","0","417","36","453","18","435","38","228","39","13","62","55","29.10.12"
"230179","82","Запорізька область","сільський будинок культури, вестибюль
вул.Гагаріна, 2А, с.Новомиколаївка, Гуляйпільський р-н, Запорізька обл., 70214","600","247","589","57","297","56","353","","0","297","56","353","10","343","35","207","25","16","50","10","29.10.12"
"230180","82","Запорізька область","сільський будинок культури, зала
вул.Петрівська, 3А, с.Петрівка, Гуляйпільський р-н, Запорізька обл., 70230","248","79","242","42","131","38","169","","0","131","38","169","4","165","10","87","27","1","26","14","28.10.12"
"230181","82","Запорізька область","школа, вестибюль
вул.Свердлова, 44, с.Полтавка, Гуляйпільський р-н, Запорізька обл., 70240","712","225","707","85","410","77","487","","0","410","77","487","15","472","61","311","41","5","20","34","28.10.12"
"230182","82","Запорізька область","сільський будинок культури, зала
вул.Леніна, 48, с.Приютне, Гуляйпільський р-н, Запорізька обл., 70241","368","111","353","32","227","30","257","","0","227","30","257","11","246","13","133","42","8","29","21","29.10.12"
"230183","82","Запорізька область","сільський будинок культури, вестибюль
вул.Шкільна, 25, с.Рівнопілля, Гуляйпільський р-н, Запорізька обл., 70216","208","55","202","23","131","22","153","","0","131","22","153","2","151","9","93","8","4","27","10","28.10.12"
"230184","82","Запорізька область","сільський будинок культури, к.3
вул.Миру, 48В, с.Темирівка, Гуляйпільський р-н, Запорізька обл., 70210","408","158","403","19","231","19","250","","0","231","19","250","8","242","12","100","17","5","104","4","28.10.12"
"230185","82","Запорізька область","сільський будинок культури, к.1
вул.Шевченка, 70, с.Успенівка, Гуляйпільський р-н, Запорізька обл., 70212","1184","491","1186","56","641","52","693","","0","641","52","693","23","670","53","370","59","20","110","58","29.10.12"
"230186","82","Запорізька область","сільський будинок культури, к.1
вул.Космічна, 1, с.Червоне, Гуляйпільський р-н, Запорізька обл., 70243","384","36","375","19","329","19","348","","0","329","19","348","11","337","25","276","20","1","4","11","29.10.12"
"230187","82","Запорізька область","Гуляйпільська центральна районна лікарня, к.504
вул.Леніна, 103, м.Гуляйполе, Гуляйпільський р-н, Запорізька обл., 70202","104","88","23","0","16","0","16","","0","16","0","16","0","16","2","10","0","0","2","2","28.10.12"
"230188","82","Запорізька область","Гуляйпільська психіатрична лікарня, к.7
вул.Дачна, 89, м.Гуляйполе, Гуляйпільський р-н, Запорізька обл., 70202","32","0","37","0","32","0","32","","0","32","0","32","2","30","0","23","2","2","3","0","29.10.12"
"230189","82","Запорізька область","Новозлатопільська психіатрична лікарня, к.6
вул.Чорного, 3А, с.Новозлатопіль, Гуляйпільський р-н, Запорізька обл., 70244","56","36","20","0","20","0","20","","0","20","0","20","4","16","0","14","0","0","2","0","28.10.12"
"230190","82","Запорізька область","школа, хол
вул.Молодіжна, 63, с.Августинівка, Запорізький р-н, Запорізька обл., 70403","1240","533","1221","97","619","88","707","","0","619","88","707","48","659","27","324","55","26","114","113","29.10.12"
"230191","82","Запорізька область","школа, актова зала
вул.Перемоги, 2, с-ще Відрадне, Запорізький р-н, Запорізька обл., 70406","1160","481","1145","67","619","60","679","","0","619","60","679","34","645","43","332","98","22","79","71","29.10.12"
"230192","82","Запорізька область","гімназія ""Престиж"", фойє
вул.Кірова, 2А, смт Балабине, Запорізький р-н, Запорізька обл., 70435","2496","1071","2458","110","1333","92","1425","","0","1333","92","1425","67","1358","104","472","201","55","363","163","29.10.12"
"230193","82","Запорізька область","будинок культури, мала зала
вул.Червона, 4, смт Балабине, Запорізький р-н, Запорізька обл., 70435","2448","1064","2408","89","1305","79","1384","","0","1305","79","1384","78","1306","120","432","154","42","379","179","29.10.12"
"230194","82","Запорізька область","будинок культури, хол
вул.30 Грудня, 24, с.Біленьке, Запорізький р-н, Запорізька обл., 70441","1328","570","1322","85","679","79","758","","0","679","79","758","32","726","43","312","58","17","236","60","29.10.12"
"230195","82","Запорізька область","школа, актова зала
вул.Шкільна, 5, с.Біленьке, Запорізький р-н, Запорізька обл., 70441","1472","672","1463","116","693","107","800","","0","693","107","800","25","775","15","431","61","19","167","82","29.10.12"
"230196","82","Запорізька область","школа, 1-й поверх
вул.Шкільна, 5, с.Біленьке, Запорізький р-н, Запорізька обл., 70441","1440","559","1430","104","783","98","881","","0","783","98","881","35","846","39","384","63","24","223","113","29.10.12"
"230197","82","Запорізька область","будинок культури, фойє
вул.Центральна, 42, с.Веселе, Запорізький р-н, Запорізька обл., 70404","688","264","672","156","277","147","424","","0","277","147","424","29","395","10","277","16","17","55","20","29.10.12"
"230198","82","Запорізька область","школа, фойє
вул.Молодіжна, 1, с.Петропіль, Запорізький р-н, Запорізька обл., 70405","648","236","636","44","368","44","412","","0","368","44","412","23","389","9","186","62","16","84","32","29.10.12"
"230199","82","Запорізька область","гімназія ""Успіх"", хол
вул.Шкільна, 13, с.Володимирівське, Запорізький р-н, Запорізька обл., 70411","2504","1036","2497","113","1373","95","1468","","0","1373","95","1468","60","1408","23","535","344","57","249","200","29.10.12"
"230200","82","Запорізька область","навчально-виховний комплекс, спортивна зала
вул.Леніна, 55, с.Григорівка, Запорізький р-н, Запорізька обл., 70452","1032","385","1018","59","593","54","647","","0","593","54","647","20","627","126","235","55","13","149","49","29.10.12"
"230201","82","Запорізька область","будинок культури, зала
вул.Зарічна, 40, с.Веселянка, Запорізький р-н, Запорізька обл., 70453","816","311","792","50","461","44","505","","0","461","44","505","21","484","29","213","35","13","143","51","28.10.12"
"230202","82","Запорізька область","будинок культури, хол
вул.Центральна, 41А, с.Долинське, Запорізький р-н, Запорізька обл., 70420","512","180","501","20","314","18","332","","0","314","18","332","12","320","80","136","19","12","46","27","29.10.12"
"230203","82","Запорізька область","будинок культури, зала
вул.Леніна, 47А, с.Нове Запоріжжя, Запорізький р-н, Запорізька обл., 70422","680","256","662","40","384","40","424","","0","384","40","424","29","395","47","143","38","13","86","68","29.10.12"
"230204","82","Запорізька область","приватне акціонерне товариство ""Високогірне"", актова зала
вул.Мічуріна, 5, с-ще Високогірне, Запорізький р-н, Запорізька обл., 70421","400","160","407","19","223","17","240","","0","223","17","240","16","224","57","69","16","5","52","25","28.10.12"
"230205","82","Запорізька область","сільський клуб, зала
вул.Миру, 23, с.Новослобідка, Запорізький р-н, Запорізька обл., 70423","360","144","357","22","194","22","216","","0","194","22","216","12","204","33","69","27","5","37","33","29.10.12"
"230206","82","Запорізька область","сільський клуб, зала
вул.Дружна, 2, с.Бабурка, Запорізький р-н, Запорізька обл., 70423","376","133","366","15","232","11","243","","0","232","11","243","20","223","6","105","31","5","48","28","29.10.12"
"230207","82","Запорізька область","навчально-виховний комплекс ""Інтелект"", к.2
вул.Шевченка, 71, смт Кушугум, Запорізький р-н, Запорізька обл., 70450","2200","1162","2167","58","990","48","1038","","0","990","48","1038","61","977","57","353","128","39","275","125","29.10.12"
"230208","82","Запорізька область","навчально-виховний комплекс ""Інтелект"", актова зала
вул.Шевченка, 71, смт Кушугум, Запорізький р-н, Запорізька обл., 70450","2160","1021","2141","97","1064","75","1139","","0","1064","75","1139","77","1062","50","448","129","56","235","144","29.10.12"
"230209","82","Запорізька область","селищна рада, зала засідань
вул.Тельмана, 23, смт Кушугум, Запорізький р-н, Запорізька обл., 70450","2296","1196","2276","57","1062","38","1100","","0","1062","38","1100","74","1026","95","397","144","39","227","124","29.10.12"
"230210","82","Запорізька область","сільський клуб, фойє
вул.Центральна, 17А, с.Лисогірка, Запорізький р-н, Запорізька обл., 70443","816","310","799","55","463","43","506","","0","463","43","506","25","481","18","229","44","12","122","56","29.10.12"
"230211","82","Запорізька область","сільський клуб, фойє
вул.Слави, б.1А, с.Канівське, Запорізький р-н, Запорізька обл., 70443","552","212","547","43","297","43","340","","0","297","43","340","15","325","6","155","44","11","87","22","29.10.12"
"230212","82","Запорізька область","комунальна власність територіальної громади, нежитлове приміщення житлового будинку, к.2
вул.Гагаріна, б.3/9, с.Біленьке Перше, Запорізький р-н, Запорізька обл., 70441","632","300","618","29","314","18","332","","0","314","18","332","20","312","8","127","24","9","108","36","29.10.12"
"230213","82","Запорізька область","будинок культури, фойє
вул.Леніна, 18, с.Лукашеве, Запорізький р-н, Запорізька обл., 70410","1008","389","996","50","579","40","619","","0","579","40","619","21","598","32","265","70","29","143","59","29.10.12"
"230214","82","Запорізька область","сільський клуб, зала
вул.Радянська, сільський клуб, с.Радянське, Запорізький р-н, Запорізька обл., 70410","128","54","121","12","62","12","74","","0","62","12","74","7","67","4","19","5","7","21","11","29.10.12"
"230215","82","Запорізька область","будинок культури, зала
вул.Клубна, 1, смт Малокатеринівка, Запорізький р-н, Запорізька обл., 70454","1056","508","1035","45","511","37","548","","0","511","37","548","29","519","123","160","39","22","126","49","29.10.12"
"230216","82","Запорізька область","гімназія ""Мрія"", каб.1
вул.Калініна, 33, смт Малокатеринівка, Запорізький р-н, Запорізька обл., 70454","1264","578","1259","39","650","36","686","","0","650","36","686","36","650","101","258","64","23","155","49","29.10.12"
"230217","82","Запорізька область","будинок культури, танцювальна зала
вул.Леніна, 38, с.Мар’ївка, Запорізький р-н, Запорізька обл., 70440","1448","659","1432","91","715","74","789","","0","715","74","789","58","731","26","418","60","23","123","81","29.10.12"
"230218","82","Запорізька область","товариство з обмеженою відповідальністю ""Січ-Агро-2005"", зала засідань
вул.Центральна, 1А, с.Новосергіївка, Запорізький р-н, Запорізька обл., 70440","280","114","275","16","150","16","166","","0","150","16","166","14","152","2","85","14","9","36","6","29.10.12"
"230219","82","Запорізька область","будинок культури, хол
вул.Центральна, 97, с.Миколай-Поле, Запорізький р-н, Запорізька обл., 70401","920","382","902","66","482","56","538","","0","482","56","538","35","503","25","202","75","20","142","39","29.10.12"
"230220","82","Запорізька область","сільський клуб-бібліотека, зала
вул.Центральна, 67, с.Новопетрівка, Запорізький р-н, Запорізька обл., 70402","784","309","774","43","437","38","475","","0","437","38","475","38","437","16","199","39","13","131","39","29.10.12"
"230221","82","Запорізька область","навчально-виховний комплекс, спортивна зала
вул.Ювілейна, 10, с.Наталівка, Запорізький р-н, Запорізька обл., 70430","968","363","958","69","542","63","605","","0","542","63","605","41","564","10","257","137","14","99","47","29.10.12"
"230222","82","Запорізька область","навчально-виховний комплекс, фойє
вул.Центральна, 19, с.Лежине, Запорізький р-н, Запорізька обл., 70431","1832","691","1803","101","1045","96","1141","","0","1045","96","1141","60","1081","41","419","225","38","161","197","29.10.12"
"230223","82","Запорізька область","школа, фойє
вул.Радянська, 14, с.Новоолександрівка, Запорізький р-н, Запорізька обл., 70433","1352","563","1342","74","722","67","789","","0","722","67","789","44","745","113","299","85","27","165","56","29.10.12"
"230224","82","Запорізька область","навчально-виховний комплекс, спортивна зала
вул.Леніна, 8А, с.Юльївка, Запорізький р-н, Запорізька обл., 70434","416","154","404","30","232","30","262","","0","232","30","262","12","250","5","104","28","11","85","17","29.10.12"
"230225","82","Запорізька область","будинок культури, хол
вул.Леніна, 24, с.Розумівка, Запорізький р-н, Запорізька обл., 70424","1616","623","1614","51","951","42","993","","0","951","42","993","47","946","48","410","149","37","198","104","29.10.12"
"230226","82","Запорізька область","сільський клуб, зала
вул.Леніна, 19А, с.Нижня Хортиця, Запорізький р-н, Запорізька обл., 70425","632","221","627","32","380","31","411","","0","380","31","411","20","391","12","152","97","14","69","47","28.10.12"
"230227","82","Запорізька область","сільський клуб, зала
вул.Берегова, 16, с.Ручаївка, Запорізький р-н, Запорізька обл., 70413","568","267","557","41","264","37","301","","0","264","37","301","10","291","4","175","18","14","54","26","29.10.12"
"230228","82","Запорізька область","Інститут олійних культур, хол
вул.Інститутська, 1, с-ще Сонячне, Запорізький р-н, Запорізька обл., 70417","880","419","868","23","444","17","461","","0","444","17","461","21","440","15","153","107","20","82","63","29.10.12"
"230229","82","Запорізька область","будинок культури, хол
вул.Нагорна, 12, с.Степне, Запорізький р-н, Запорізька обл., 70432","1376","430","1352","50","903","43","946","","0","903","43","946","55","891","56","343","161","29","217","85","29.10.12"
"230230","82","Запорізька область","сільський клуб, зала
вул.Миру, 73, с.Шевченківське, Запорізький р-н, Запорізька обл., 70433","304","119","298","11","177","8","185","","0","177","8","185","13","172","9","45","33","9","62","14","29.10.12"
"230231","82","Запорізька область","будинок культури, мала зала
вул.Радянська, 2, с.Широке, Запорізький р-н, Запорізька обл., 70413","944","330","927","59","558","56","614","","0","558","56","614","30","584","10","277","109","14","94","80","29.10.12"
"230232","82","Запорізька область","комунальна установа ""Обласна туберкульозна лікарня"", кімната харчоблоку
вул.Миру, 5, с.Веселянка, Запорізький р-н, Запорізька обл., 70453","96","56","41","0","40","0","40","","0","40","0","40","3","37","4","9","8","2","9","5","28.10.12"
"230233","82","Запорізька область","Біленьківська виправна колонія №99, підсобне приміщення
вул.Запорізька, 32, с.Біленьке, Запорізький р-н, Запорізька обл., 70441","1232","37","1195","0","1195","0","1195","","0","1195","0","1195","39","1156","11","1063","42","7","13","20","29.10.12"
"230359","82","Запорізька область","районний будинок культури, фойє
вул.Леніна, 25, смт Новомиколаївка, Новомиколаївський р-н, Запорізька обл., 70100","1928","841","1901","65","1036","51","1087","","0","1036","51","1087","36","1051","14","328","592","22","32","63","29.10.12"
"230360","82","Запорізька область","районний центр дитячої творчості, актова зала
вул.Леніна, 35, смт Новомиколаївка, Новомиколаївський р-н, Запорізька обл., 70100","1752","728","1730","31","999","25","1024","","0","999","25","1024","33","991","18","299","526","13","50","85","29.10.12"
"230361","82","Запорізька область","адмінбудинок ТОВ ""Запорожець"", актова зала
вул.Комсомольська, 168, смт Новомиколаївка, Новомиколаївський р-н, Запорізька обл., 70100","1224","514","1203","69","642","68","710","","0","642","68","710","32","678","13","286","273","11","43","52","29.10.12"
"230362","82","Запорізька область","школа, хол
вул.Леніна, 20, смт Тернувате, Новомиколаївський р-н, Запорізька обл., 70150","1184","547","1165","74","578","59","637","","0","578","59","637","23","614","7","169","187","13","49","189","29.10.12"
"230363","82","Запорізька область","сільський будинок культури, актова зала
вул.Леніна, 1В, с.Барвінівка, Новомиколаївський р-н, Запорізька обл., 70151","432","178","415","32","229","25","254","","0","229","25","254","10","244","0","82","121","6","20","15","28.10.12"
"230364","82","Запорізька область","школа, фойє
вул.Первомайська, 21, с.Веселий Гай, Новомиколаївський р-н, Запорізька обл., 70120","448","131","437","29","290","27","317","","0","290","27","317","12","305","5","167","97","3","15","18","29.10.12"
"230365","82","Запорізька область","сільський будинок культури, обрядова зала
вул.Миру, 19, с.Зелене, Новомиколаївський р-н, Запорізька обл., 70140","480","206","477","34","244","30","274","","0","244","30","274","9","265","3","119","83","4","35","21","29.10.12"
"230366","82","Запорізька область","сільський будинок культури, фойє
вул.Леніна, 3, с.Любицьке, Новомиколаївський р-н, Запорізька обл., 70153","536","145","543","139","258","133","391","","0","258","133","391","12","379","7","202","81","6","41","42","28.10.12"
"230367","82","Запорізька область","школа, хол
вул.Гриценка, 8, с.Новоіванківка, Новомиколаївський р-н, Запорізька обл., 70110","568","182","563","85","302","84","386","","0","302","84","386","18","368","8","98","164","5","34","59","29.10.12"
"230368","82","Запорізька область","сільський будинок культури, актова зала
вул.Миру, 1А, с.Підгірне, Новомиколаївський р-н, Запорізька обл., 70121","880","305","873","59","528","47","575","","0","528","47","575","28","547","2","217","255","7","25","41","28.10.12"
"230369","82","Запорізька область","сільський будинок культури, фойє
вул.Леніна, 32, с.Різдвянка, Новомиколаївський р-н, Запорізька обл., 70152","448","182","446","44","223","43","266","","0","223","43","266","9","257","2","46","114","11","15","69","28.10.12"
"230370","82","Запорізька область","сільський будинок культури, актова зала
вул.Центральна, 46, с.Самійлівка, Новомиколаївський р-н, Запорізька обл., 70142","520","202","512","74","246","72","318","","0","246","72","318","12","306","2","117","92","4","25","66","29.10.12"
"230371","82","Запорізька область","сільський будинок культури, фойє
вул.Комсомольська, 3, с.Софіївка, Новомиколаївський р-н, Запорізька обл., 70113","672","210","651","67","399","63","462","","0","399","63","462","11","451","6","217","150","11","17","50","29.10.12"
"230372","82","Запорізька область","сільський будинок культури, актова зала
вул.Центральна, 12, с.Сторчове, Новомиколаївський р-н, Запорізька обл., 70112","640","290","622","93","271","79","350","","0","271","79","350","13","337","3","101","125","7","49","52","28.10.12"
"230373","82","Запорізька область","навчально-виховний комплекс, спортивна зала
вул.імені Євгена Карташова, 84, с.Терсянка, Новомиколаївський р-н, Запорізька обл., 70132","1064","478","1055","76","517","69","586","","0","517","69","586","29","557","15","189","262","9","38","44","29.10.12"
"230374","82","Запорізька область","школа, спортивна зала
вул.Будьонного, 1, с-ще Трудове, Новомиколаївський р-н, Запорізька обл., 70130","688","265","681","48","382","41","423","","0","382","41","423","19","404","10","111","149","6","58","70","28.10.12"
"230375","82","Запорізька область","центральна районна лікарня, каб.4
вул.Стадіонна, 2, с.Михайлівське, Новомиколаївський р-н, Запорізька обл., 70100","56","36","21","2","18","2","20","","0","18","2","20","0","20","0","6","12","0","0","2","28.10.12"
"230387","82","Запорізька область","школа, спортивна зала
вул.Космічна, 46А, с.Вільнянка, Оріхівський р-н, Запорізька обл., 70520","440","191","431","21","229","20","249","","0","229","20","249","10","239","5","87","73","2","51","21","28.10.12"
"230393","82","Запорізька область","адміністративна будівля сільської ради, кабінет сільського голови
вул.40 років Перемоги, 57, с.Микільське, Оріхівський р-н, Запорізька обл., 70521","312","128","305","25","160","24","184","","0","160","24","184","14","170","3","55","18","4","54","36","28.10.12"
"230400","82","Запорізька область","школа, спортивна зала
вул.Шкільна, 11, с.Новоселівка, Оріхівський р-н, Запорізька обл., 70523","448","164","434","44","244","40","284","","0","244","40","284","6","278","4","132","10","4","70","58","29.10.12"
"230407","82","Запорізька область","адміністративна будівля сільської ради, зала засідань
вул.Перемоги, 4, с.Омельник, Оріхівський р-н, Запорізька обл., 70522","552","191","545","46","316","45","361","","0","316","45","361","15","346","5","196","26","1","75","43","29.10.12"
"230415","82","Запорізька область","ПП ""Полетехніка-Сервіс"", їдальня
вул.Зарічна, 55А, м.Пологи, Пологівський р-н, Запорізька обл., 70602","696","331","694","62","303","62","365","","0","303","62","365","21","344","14","140","62","19","46","63","28.10.12"
"230416","82","Запорізька область","колегіум №1, велика спортзала
вул.Пролетарська, 18, м.Пологи, Пологівський р-н, Запорізька обл., 70600","1672","772","1656","54","857","43","900","","0","856","43","899","44","855","29","267","267","49","74","169","30.10.12"
"230417","82","Запорізька область","школа №4, актова зала
вул.імені Героя України Сацького В.А., 3, м.Пологи, Пологівський р-н, Запорізька обл., 70600","2232","957","2197","49","1235","40","1275","","0","1235","40","1275","48","1227","56","352","434","65","126","194","29.10.12"
"230418","82","Запорізька область","районний будинок культури, мала зала
вул.імені Героя України Сацького В.А., 7, м.Пологи, Пологівський р-н, Запорізька обл., 70600","1392","608","1375","25","759","25","784","","0","759","25","784","42","742","41","227","234","24","91","125","29.10.12"
"230419","82","Запорізька область","адмінбудівля ТОВ ""ОМЗ ГРУП"", актова зала
вул.К.Маркса, 291, м.Пологи, Пологівський р-н, Запорізька обл., 70607","1896","782","1880","39","1077","37","1114","","0","1077","37","1114","56","1058","114","354","288","29","126","147","29.10.12"
"230420","82","Запорізька область","комунальний будинок культури ""Гірник"", хол
вул.К.Маркса, 500, м.Пологи, Пологівський р-н, Запорізька обл., 70605","2248","1043","2223","47","1168","37","1205","","0","1168","37","1205","59","1146","102","295","393","45","176","135","29.10.12"
"230421","82","Запорізька область","школа №2, спортзала
вул.Червоногвардійська, 29, м.Пологи, Пологівський р-н, Запорізька обл., 70605","1176","575","1150","18","590","11","601","","0","590","11","601","27","574","73","156","183","25","75","62","29.10.12"
"230422","82","Запорізька область","гімназія ""Основа"", спортзала
вул.МТС, 2, м.Пологи, Пологівський р-н, Запорізька обл., 70604","944","441","916","27","477","26","503","","0","477","26","503","25","478","19","172","126","30","47","84","29.10.12"
"230423","82","Запорізька область","адмінбудівля Пологівського АТП, актова зала
вул.Східна, 15, м.Пологи, Пологівський р-н, Запорізька обл., 70606","2416","1056","2375","37","1335","25","1360","","0","1335","25","1360","68","1292","46","387","464","71","144","180","29.10.12"
"230424","82","Запорізька область","професійний ліцей, хол
вул.Дружби, 70, м.Пологи, Пологівський р-н, Запорізька обл., 70607","1360","573","1352","51","740","47","787","","0","740","47","787","40","747","41","249","203","36","108","110","29.10.12"
"230425","82","Запорізька область","адмінбудівля локомотивного депо, зала
вул.Ульянова, 1, м.Пологи, Пологівський р-н, Запорізька обл., 70604","1248","561","1228","26","664","23","687","","0","664","23","687","37","650","21","204","192","49","64","120","29.10.12"
"230426","82","Запорізька область","будинок культури, глядацька зала
вул.Леніна, 173А, с.Басань, Пологівський р-н, Запорізька обл., 70643","488","223","482","53","220","45","265","","0","220","45","265","11","254","3","99","44","13","60","35","29.10.12"
"230427","82","Запорізька область","школа, хол
вул.Шкільна, 1, с.Басань, Пологівський р-н, Запорізька обл., 70640","680","319","676","24","341","20","361","","0","341","20","361","16","345","24","135","75","23","30","58","29.10.12"
"230428","82","Запорізька область","будинок культури, глядацька зала
вул.Леніна, 179, с.Вербове, Пологівський р-н, Запорізька обл., 70633","752","321","742","65","376","55","431","","0","376","55","431","22","409","28","167","54","7","86","67","29.10.12"
"230429","82","Запорізька область","школа, зала
вул.Леніна, 44А, с.Григорівка, Пологівський р-н, Запорізька обл., 70661","808","325","796","103","392","91","483","","0","392","91","483","12","471","47","128","37","17","87","155","28.10.12"
"230430","82","Запорізька область","сільська рада, актова зала
вул.Шевченка, 43Б, с.Інженерне, Пологівський р-н, Запорізька обл., 70635","600","243","600","30","330","27","357","","0","330","27","357","15","342","49","141","71","14","22","45","29.10.12"
"230431","82","Запорізька область","школа, спортзала
вул.Леніна, 93Б, с.Інженерне, Пологівський р-н, Запорізька обл., 70631","776","308","759","63","414","54","468","","0","414","54","468","19","449","19","182","92","30","50","76","28.10.12"
"230432","82","Запорізька область","школа, спортзала
вул.Молодіжна, 100, с.Новофедорівка, Пологівський р-н, Запорізька обл., 70632","328","136","327","37","159","33","192","","0","159","33","192","3","189","7","118","11","3","23","27","28.10.12"
"230433","82","Запорізька область","навчально-виховний комплекс, хол
вул.Леніна, 60, с.Кінські Роздори, Пологівський р-н, Запорізька обл., 70651","1016","454","1005","45","517","45","562","","0","517","45","562","32","530","50","182","76","33","72","117","28.10.12"
"230434","82","Запорізька область","клуб ""Зелений Яр"", хол
вул.Щорса, 36, с.Кінські Роздори, Пологівський р-н, Запорізька обл., 70650","1096","465","1080","48","589","42","631","","0","589","42","631","26","605","30","216","92","80","68","119","29.10.12"
"230435","82","Запорізька область","фельдшерсько-акушерський пункт, каб.1
вул.Центральна, 1, с-ще Магедове, Пологівський р-н, Запорізька обл., 70652","168","53","159","16","102","13","115","","0","102","13","115","3","112","2","62","10","6","12","20","28.10.12"
"230436","82","Запорізька область","сільський клуб, глядацька зала
вул.Калініна, 31, с.Костянтинівка, Пологівський р-н, Запорізька обл., 70618","456","176","443","41","243","37","280","","0","243","37","280","15","265","13","149","22","9","41","31","28.10.12"
"230437","82","Запорізька область","будинок культури, зала
вул.Гагаріна, 82, с.Новоселівка, Пологівський р-н, Запорізька обл., 70620","744","311","731","49","386","47","433","","0","386","47","433","19","414","5","204","65","28","48","64","28.10.12"
"230438","82","Запорізька область","адмінбудівля ТОВ ""Пологівський шляхбуд"", актова зала
вул.Леніна, 162, с.Пологи, Пологівський р-н, Запорізька обл., 70615","1152","529","1120","41","586","37","623","","0","586","37","623","24","599","26","202","193","34","54","90","29.10.12"
"230439","82","Запорізька область","сільський клуб, глядацька зала
вул.Леніна, 186, с.Пологи, Пологівський р-н, Запорізька обл., 70615","1296","512","1278","51","740","44","784","","0","740","44","784","35","749","62","238","160","104","60","125","28.10.12"
"230440","82","Запорізька область","фельдшерсько-акушерський пункт, каб.2
вул.Миру, 45А, с.Івана Франка, Пологівський р-н, Запорізька обл., 70615","200","56","203","8","137","7","144","","0","137","7","144","12","132","7","55","18","8","29","15","29.10.12"
"230441","82","Запорізька область","сільська рада, зала засідань
вул.Жовтнева, 6, с.Семенівка, Пологівський р-н, Запорізька обл., 70660","800","358","789","81","368","74","442","","0","368","74","442","13","429","122","109","43","16","72","67","29.10.12"
"230442","82","Запорізька область","школа, спортзала
вул.Леніна, 78, с.Тарасівка, Пологівський р-н, Запорізька обл., 70640","1008","492","995","78","444","72","516","","0","444","72","516","14","502","14","199","82","22","123","62","29.10.12"
"230443","82","Запорізька область","школа, хол
вул.Горького, 34А, с.Шевченкове, Пологівський р-н, Запорізька обл., 70642","440","164","436","60","220","56","276","","0","220","56","276","8","268","12","116","50","22","39","29","29.10.12"
"230444","82","Запорізька область","будинок культури, зала
вул.Леніна, 153, с.Чапаєвка, Пологівський р-н, Запорізька обл., 70625","640","307","629","22","314","19","333","","0","314","19","333","16","317","7","111","23","81","63","32","28.10.12"
"230445","82","Запорізька область","середня школа, спортзала
вул.Матросова, 2, с.Чапаєвка, Пологівський р-н, Запорізька обл., 70624","1976","1031","1946","21","925","20","945","","0","925","20","945","42","903","23","317","177","115","149","122","29.10.12"
"230446","82","Запорізька область","будинок культури, глядацька зала
вул.Леніна, 38, с.Чубарівка, Пологівський р-н, Запорізька обл., 70627","816","363","801","45","412","41","453","","0","412","41","453","23","430","16","103","85","29","100","97","28.10.12"
"230447","82","Запорізька область","професійний ліцей, хол
вул.Артема, 1, с.Чубарівка, Пологівський р-н, Запорізька обл., 70627","576","296","573","57","225","55","280","","0","225","55","280","7","273","6","118","46","7","61","35","29.10.12"
"230448","82","Запорізька область","їдальня сільської ради, зала
вул.Суворова, 66, с.Чубарівка, Пологівський р-н, Запорізька обл., 70627","256","117","249","25","116","23","139","","0","116","23","139","6","133","17","38","22","3","16","37","28.10.12"
"230449","82","Запорізька область","школа, хол
вул.Леніна, 4, с.Балочки, Пологівський р-н, Запорізька обл., 70628","304","136","298","21","149","19","168","","0","149","19","168","6","162","5","68","20","7","36","26","29.10.12"
"230450","82","Запорізька область","центральна районна лікарня, хол
вул.імені Героя України Сацького В.А., 6/90, м.Пологи, Пологівський р-н, Запорізька обл., 70600","40","4","48","13","23","13","36","","0","23","13","36","3","33","1","14","7","0","4","7","28.10.12"
